,title,year,production_budget,domestic_gross,worldwide_gross,profit,ROI,success
0,Avengers: Endgame,2019,400000000,858373000,2797800564,2397800564,5.99,1
1,Pirates of the Caribbean: On Stranger Tides,2011,379000000,241063875,1045663875,666663875,1.76,1
2,Avengers: Age of Ultron,2015,365000000,459005868,1396099202,1031099202,2.82,1
3,Star Wars Ep. VII: The Force Awakens,2015,306000000,936662225,2068223624,1762223624,5.76,1
4,Avengers: Infinity War,2018,300000000,678815482,2048359754,1748359754,5.83,1
5,Pirates of the Caribbean: At Worldâs End,2007,300000000,309420425,963420425,663420425,2.21,1
6,Justice League,2017,300000000,229024295,655945209,355945209,1.19,0
7,Spectre,2015,300000000,200074175,879620923,579620923,1.93,1
8,Star Wars: The Rise of Skywalker,2019,275000000,515202542,1073469600,798469600,2.9,1
9,Solo: A Star Wars Story,2018,275000000,213767512,393151347,118151347,0.43,0
10,John Carter,2012,263700000,73058679,282778100,19078100,0.07,0
11,Batman v Superman: Dawn of Justice,2016,263000000,330360194,872395091,609395091,2.32,1
12,The Lion King,2019,260000000,543638043,1656943394,1396943394,5.37,1
13,Tangled,2010,260000000,200821936,585727091,325727091,1.25,0
14,Spider-Man 3,2007,258000000,336530303,894860230,636860230,2.47,1
15,Captain America: Civil War,2016,250000000,408084349,1153284349,903284349,3.61,1
16,Harry Potter and the Half-Blood Prince,2009,250000000,302089278,935213767,685213767,2.74,1
17,The Hobbit: The Desolation of Smaug,2013,250000000,258241522,960241522,710241522,2.84,1
18,The Hobbit: The Battle of the Five Armies,2014,250000000,255119788,945577621,695577621,2.78,1
19,The Fate of the Furious,2017,250000000,225764765,1238764765,988764765,3.96,1
21,Avatar,2009,237000000,760507625,2788701337,2551701337,10.77,1
22,Superman Returns,2006,232000000,200120000,391081192,159081192,0.69,0
23,The Dark Knight Rises,2012,230000000,448139099,1084439099,854439099,3.71,1
24,Pirates of the Caribbean: Dead Men Tell No Tales,2017,230000000,172558876,788241137,558241137,2.43,1
25,Quantum of Solace,2008,230000000,169368427,591692078,361692078,1.57,1
26,The Avengers,2012,225000000,623357910,1515100211,1290100211,5.73,1
27,Pirates of the Caribbean: Dead Manâs Chest,2006,225000000,423315812,1066215812,841215812,3.74,1
28,Man of Steel,2013,225000000,291045518,667999518,442999518,1.97,1
29,The Chronicles of Narnia: Prince Caspian,2008,225000000,141621490,417341288,192341288,0.85,0
30,The Lone Ranger,2013,225000000,89302115,260002115,35002115,0.16,0
32,The Amazing Spider-Man,2012,220000000,262030663,757890267,537890267,2.44,1
33,Battleship,2012,220000000,65233400,313477717,93477717,0.42,0
34,Transformers: The Last Knight,2017,217000000,130168683,602893340,385893340,1.78,1
35,Jurassic World,2015,215000000,652270625,1670400637,1455400637,6.77,1
36,Men in Black 3,2012,215000000,179020854,654213485,439213485,2.04,1
37,Transformers: Revenge of the Fallen,2009,210000000,402111870,836519699,626519699,2.98,1
38,Transformers: Age of Extinction,2014,210000000,245439076,1104054072,894054072,4.26,1
39,X-Men: The Last Stand,2006,210000000,234362462,459260946,249260946,1.19,0
40,Robin Hood,2010,210000000,105487148,322459006,112459006,0.54,0
41,King Kong,2005,207000000,218080025,550517357,343517357,1.66,1
42,The Golden Compass,2007,205000000,70107728,367262558,162262558,0.79,0
43,Black Panther,2018,200000000,700059566,1346103376,1146103376,5.73,1
45,Star Wars Ep. VIII: The Last Jedi,2017,200000000,620181382,1332539889,1132539889,5.66,1
46,Incredibles 2,2018,200000000,608581744,1242805359,1042805359,5.21,1
47,Rogue One: A Star Wars Story,2016,200000000,532177324,1056057273,856057273,4.28,1
48,Finding Dory,2016,200000000,486295561,1025363627,825363627,4.13,1
49,Toy Story 4,2019,200000000,434038008,1073394813,873394813,4.37,1
50,Toy Story 3,2010,200000000,415004880,1068879522,868879522,4.34,1
51,Iron Man 3,2013,200000000,408992272,1215392272,1015392272,5.08,1
52,Guardians of the Galaxy Vol 2,2017,200000000,389813101,869113101,669113101,3.35,1
53,Spider-Man 2,2004,200000000,373524485,794697557,594697557,2.97,1
54,Alice in Wonderland,2010,200000000,334191110,1025491110,825491110,4.13,1
55,Skyfall,2012,200000000,304360277,1110526981,910526981,4.55,1
56,The Hobbit: An Unexpected Journey,2012,200000000,303003568,1017003568,817003568,4.09,1
57,Monsters University,2013,200000000,268488329,743588329,543588329,2.72,1
58,Oz the Great and Powerful,2013,200000000,234770996,490359051,290359051,1.45,0
59,X-Men: Days of Future Past,2014,200000000,233921534,747862775,547862775,2.74,1
60,The Amazing Spider-Man 2,2014,200000000,202853933,708996336,508996336,2.54,1
61,Cars 2,2011,200000000,191450875,560155383,360155383,1.8,1
62,Fast &amp; Furious Presents: Hobbs &amp; Shaw,2019,200000000,173956935,760574453,560574453,2.8,1
63,Tron: Legacy,2010,200000000,172062763,400062763,200062763,1.0,0
64,2012,2009,200000000,166112167,757677748,557677748,2.79,1
65,Fantastic Beasts: The Crimes of Grindelwald,2018,200000000,159555901,652220086,452220086,2.26,1
66,Terminator Salvation,2009,200000000,125322469,365491792,165491792,0.83,0
67,Green Lantern,2011,200000000,116601172,219535492,19535492,0.1,0
68,Prince of Persia: Sands of Time,2010,200000000,90759676,336359676,136359676,0.68,0
69,Dark Phoenix,2019,200000000,65845974,246356895,46356895,0.23,0
70,Transformers: Dark of the Moon,2011,195000000,352390543,1123794079,928794079,4.76,1
71,The Mummy,2017,195000000,80101125,409953905,214953905,1.1,0
72,Jack the Giant Slayer,2013,195000000,65187603,197687603,2687603,0.01,0
73,Furious 7,2015,190000000,353007020,1518722794,1328722794,6.99,1
74,Star Trek Into Darkness,2013,190000000,228778661,467381584,277381584,1.46,0
75,World War Z,2013,190000000,202359711,531514650,341514650,1.8,1
76,The Great Gatsby,2013,190000000,144840419,353640419,163640419,0.86,0
77,Disneyâs A Christmas Carol,2009,190000000,137855863,315709697,125709697,0.66,0
78,Pacific Rim,2013,190000000,101802906,411002906,221002906,1.16,0
79,The Good Dinosaur,2015,187500000,123087120,333771037,146271037,0.78,0
80,Iron Man,2008,186000000,318604126,585171547,399171547,2.15,1
81,The Dark Knight,2008,185000000,533720947,1001996207,816996207,4.42,1
82,Indiana Jones and the Kingdom of the Crystal Skull,2008,185000000,317101119,786635413,601635413,3.25,1
83,Brave,2012,185000000,237282182,554606532,369606532,2.0,1
84,Kong: Skull Island,2017,185000000,168052812,561072059,376072059,2.03,1
85,Star Trek Beyond,2016,185000000,158848340,335802233,150802233,0.82,0
86,Maleficent: Mistress of Evil,2019,185000000,113929605,489346495,304346495,1.65,1
87,Blade Runner 2049,2017,185000000,92054159,259349919,74349919,0.4,0
88,Terminator: Dark Fate,2019,185000000,62253077,250372367,65372367,0.35,0
89,Aladdin,2019,182000000,355559216,1050959216,868959216,4.77,1
90,Thor: Ragnarok,2017,180000000,315058289,853958289,673958289,3.74,1
91,"The Chronicles of Narnia: The Lion, the Witch a…",2005,180000000,291710957,720539572,540539572,3.0,1
92,Maleficent,2014,180000000,241407328,758536735,578536735,3.21,1
93,Fantastic Beasts and Where to Find Them,2016,180000000,234037575,814037575,634037575,3.52,1
94,WALL-E,2008,180000000,223808164,532508025,352508025,1.96,1
95,Rush Hour 3,2007,180000000,140125968,256585882,76585882,0.43,0
96,The Legend of Tarzan,2016,180000000,126643061,348902025,168902025,0.94,0
97,Hugo,2011,180000000,73864507,180047784,47784,0.0,0
98,Valerian and the City of a Thousand Planets,2017,180000000,40479370,215098356,35098356,0.19,0
99,Jupiter Ascending,2015,179000000,47482519,181982519,2982519,0.02,0
100,Mission: ImpossibleâFallout,2018,178000000,220159104,787456552,609456552,3.42,1
101,X-Men: Apocalypse,2016,178000000,155442489,542537546,364537546,2.05,1
102,The Meg,2018,178000000,145443742,529530715,351530715,1.97,1
103,Edge of Tomorrow,2014,178000000,100206256,370541256,192541256,1.08,0
104,Captain Marvel,2019,175000000,426829839,1129729839,954729839,5.46,1
105,The Jungle Book,2016,175000000,364001123,962854547,787854547,4.5,1
106,Inside Out,2015,175000000,356461711,855373602,680373602,3.89,1
107,Spider-Man: Homecoming,2017,175000000,334201140,880166350,705166350,4.03,1
108,Suicide Squad,2016,175000000,325100054,746846894,571846894,3.27,1
109,Up,2009,175000000,293004164,731463377,556463377,3.18,1
110,Coco,2017,175000000,209726015,799976015,624976015,3.57,1
111,Ralph Breaks The Internet,2018,175000000,201091711,529290830,354290830,2.02,1
112,Monsters vs. Aliens,2009,175000000,198351526,381687380,206687380,1.18,0
113,Cars 3,2017,175000000,152901115,383541369,208541369,1.19,0
114,G.I. Joe: The Rise of Cobra,2009,175000000,150201498,302469017,127469017,0.73,0
116,The Mummy: Tomb of the Dragon Emperor,2008,175000000,102491776,405760225,230760225,1.32,0
117,Evan Almighty,2007,175000000,100289690,174131329,-868671,-0.0,0
119,Dolittle,2020,175000000,77047065,225847303,50847303,0.29,0
120,King Arthur: Legend of the Sword,2017,175000000,39175066,139630336,-35369664,-0.2,0
121,47 Ronin,2013,175000000,38362475,151716815,-23283185,-0.13,0
122,Jurassic World: Fallen Kingdom,2018,170000000,417719760,1308470988,1138470988,6.7,1
123,Guardians of the Galaxy,2014,170000000,333172112,772772112,602772112,3.55,1
124,Iron Man 2,2010,170000000,312433331,621156389,451156389,2.65,1
125,Captain America: The Winter Soldier,2014,170000000,259746958,714401889,544401889,3.2,1
126,Dawn of the Planet of the Apes,2014,170000000,208545589,710644566,540644566,3.18,1
127,The Polar Express,2004,170000000,188042855,312183437,142183437,0.84,0
128,Snow White and the Huntsman,2012,170000000,155136755,401021746,231021746,1.36,0
129,Terminator 3: Rise of the Machines,2003,170000000,150358296,433058296,263058296,1.55,1
130,Van Helsing,2004,170000000,120150546,300150546,130150546,0.77,0
131,Dumbo,2019,170000000,114766307,353166307,183166307,1.08,0
132,Godzilla: King of the Monsters,2019,170000000,110500138,383299915,213299915,1.25,0
133,Tomorrowland,2015,170000000,93436322,206627518,36627518,0.22,0
134,Alita: Battle Angel,2019,170000000,85710210,401779739,231779739,1.36,0
135,Alice Through the Looking Glass,2016,170000000,77042381,276928112,106928112,0.63,0
136,Shrek Forever After,2010,165000000,238736787,756244673,591244673,3.58,1
137,Doctor Strange,2016,165000000,232641920,676404566,511404566,3.1,1
138,Big Hero 6,2014,165000000,222527828,652127828,487127828,2.95,1
139,How to Train Your Dragon,2010,165000000,217581232,494870992,329870992,2.0,1
140,Wreck-It Ralph,2012,165000000,189412677,496511521,331511521,2.01,1
141,Interstellar,2014,165000000,188017894,665243134,500243134,3.03,1
142,Independence Day: Resurgence,2016,165000000,103144286,384169424,219169424,1.33,0
143,Cowboys and Aliens,2011,163000000,100368560,176038324,13038324,0.08,0
144,Beauty and the Beast,2017,160000000,504014165,1263204500,1103204500,6.9,1
145,Spider-Man: Far From Home,2019,160000000,390532085,1128764856,968764856,6.05,1
146,Aquaman,2018,160000000,335061807,1143966520,983966520,6.15,1
147,Shrek the Third,2007,160000000,322719944,807330936,647330936,4.05,1
148,Inception,2010,160000000,292576195,832551961,672551961,4.2,1
149,The Hunger Games: Mockingjay - Part 2,2015,160000000,281723902,648986787,488986787,3.06,1
150,Fast and Furious 6,2013,160000000,238679850,789300444,629300444,3.93,1
151,Godzilla,2014,160000000,200676069,529076069,369076069,2.31,1
152,X-Men: First Class,2011,160000000,146408305,355408305,195408305,1.22,0
153,The Curious Case of Benjamin Button,2008,160000000,127509326,329631958,169631958,1.06,0
154,The Sorcerer's Apprentice,2010,160000000,63150991,217986320,57986320,0.36,0
155,Poseidon,2006,160000000,60674817,181674817,21674817,0.14,0
156,Warcraft,2016,160000000,47365290,438899824,278899824,1.74,1
158,Deepwater Horizon,2016,156000000,61433527,122603824,-33396176,-0.21,0
159,The Chronicles of Narnia: The Voyage of the Daw…,2010,155000000,104386950,418186950,263186950,1.7,1
160,Terminator: Genisys,2015,155000000,89760956,432150894,277150894,1.79,1
161,Pacific Rim: Uprising,2018,155000000,59874525,290930148,135930148,0.88,0
162,Alexander,2004,155000000,34297191,167297191,12297191,0.08,0
163,War for the Planet of the Apes,2017,152000000,146880162,489592267,337592267,2.22,1
164,Pearl Harbor,2001,151500000,198539855,449239853,297739853,1.97,1
165,Transformers,2007,151000000,319246193,708272592,557272592,3.69,1
166,Frozen II,2019,150000000,477373578,1447551752,1297551752,8.65,1
167,Wonder Woman,2017,150000000,412563408,821133378,671133378,4.47,1
168,Frozen,2013,150000000,400738009,1268746174,1118746174,7.46,1
169,Zootopia,2016,150000000,341268248,1023784195,873784195,5.83,1
170,Harry Potter and the Order of the Phoenix,2007,150000000,292137260,943076457,793076457,5.29,1
171,Harry Potter and the Goblet of Fire,2005,150000000,290201752,897099794,747099794,4.98,1
172,The Matrix Reloaded,2003,150000000,281553689,738576929,588576929,3.92,1
173,I am Legend,2007,150000000,256393010,585532684,435532684,2.9,1
174,Moana,2016,150000000,248757044,636927067,486927067,3.25,1
175,Hancock,2008,150000000,227946274,624234272,474234272,3.16,1
176,Charlie and the Chocolate Factory,2005,150000000,206459076,475825484,325825484,2.17,1
177,Ratatouille,2007,150000000,206445654,626549695,476549695,3.18,1
178,Thor: The Dark World,2013,150000000,206362140,644602516,494602516,3.3,1
179,Batman Begins,2005,150000000,205343774,359142722,209142722,1.39,0
180,Mission: ImpossibleâRogue Nation,2015,150000000,195042377,688858992,538858992,3.59,1
181,Dunkirk,2017,150000000,190068280,527268280,377268280,2.52,1
182,Thor,2011,150000000,181030624,449326618,299326618,2.0,1
183,Madagascar: Escape 2 Africa,2008,150000000,180174880,599680774,449680774,3.0,1
184,X-Men Origins: Wolverine,2009,150000000,179883157,374825760,224825760,1.5,1
185,Night at the Museum: Battle of the Smithsonian,2009,150000000,177243721,402231063,252231063,1.68,1
186,Kung Fu Panda 2,2011,150000000,165249063,664837547,514837547,3.43,1
187,Mad Max: Fury Road,2015,150000000,153636354,368269061,218269061,1.46,0
188,PokÃ©mon: Detective Pikachu,2019,150000000,144105346,433005346,283005346,1.89,1
189,The Matrix Revolutions,2003,150000000,139270910,427300260,277300260,1.85,1
190,Ready Player One,2018,150000000,137690172,579278642,429278642,2.86,1
191,Chicken Little,2005,150000000,135386665,310043823,160043823,1.07,0
192,Mission: Impossible III,2006,150000000,133501348,399387745,249387745,1.66,1
193,Angels &amp; Demons,2009,150000000,133375846,490875846,340875846,2.27,1
194,Troy,2004,150000000,133298577,483152040,333152040,2.22,1
195,The Last Airbender,2010,150000000,131772187,319713881,169713881,1.13,0
196,Bee Movie,2007,150000000,126631277,287594577,137594577,0.92,0
197,G-Force,2009,150000000,119436770,292817841,142817841,0.95,0
198,Bolt,2008,150000000,114053579,328015029,178015029,1.19,0
199,Wrath of the Titans,2012,150000000,83670083,305270083,155270083,1.04,0
200,Beowulf,2007,150000000,82280579,195080579,45080579,0.3,0
201,Dark Shadows,2012,150000000,79727149,238202668,88202668,0.59,0
202,White House Down,2013,150000000,73103784,205440387,55440387,0.37,0
203,The Wolfman,2010,150000000,62189884,142634358,-7365642,-0.05,0
204,The Great Wall,2016,150000000,45157105,334486852,184486852,1.23,0
205,Pan,2015,150000000,35088320,151525973,1525973,0.01,0
206,Mars Needs Moms,2011,150000000,21392758,39549758,-110450242,-0.74,0
208,Flushed Away,2006,149000000,64665672,179357126,30357126,0.2,0
209,Madagascar 3: Europe's Most Wanted,2012,145000000,216391482,746921271,601921271,4.15,1
210,Mission: ImpossibleâGhost Protocol,2011,145000000,209397903,694713230,549713230,3.79,1
211,How to Train Your Dragon 2,2014,145000000,177002924,614586270,469586270,3.24,1
213,Mr. Peabody &amp; Sherman,2014,145000000,111506430,269806430,124806430,0.86,0
214,Rise of the Guardians,2012,145000000,103412758,306900902,161900902,1.12,0
215,Sahara,2005,145000000,68671925,121671925,-23328075,-0.16,0
216,Ghostbusters,2016,144000000,128350574,229008658,85008658,0.59,0
217,Die Another Day,2002,142000000,160942139,431942139,289942139,2.04,1
218,Pirates of the Caribbean: The Curse of the Blac…,2003,140000000,305410819,654310819,514310819,3.67,1
219,Star Trek,2009,140000000,257730019,386839614,246839614,1.76,1
221,Men in Black 2,2002,140000000,190418803,441767803,301767803,2.16,1
222,Captain America: The First Avenger,2011,140000000,176654505,370569776,230569776,1.65,1
223,Kung Fu Panda 3,2016,140000000,143528619,521170825,381170825,2.72,1
225,G.I. Joe: Retaliation,2013,140000000,122523060,375740705,235740705,1.68,1
226,The Last Samurai,2003,140000000,111110575,456810575,316810575,2.26,1
227,Fun With Dick And Jane,2005,140000000,110550000,203018919,63018919,0.45,0
228,Exodus: Gods and Kings,2014,140000000,65014513,268314513,128314513,0.92,0
229,The BFG,2016,140000000,55483770,199646680,59646680,0.43,0
230,Gemini Man,2019,140000000,48546770,166623705,26623705,0.19,0
231,Gods of Egypt,2016,140000000,31153464,138836756,-1163244,-0.01,0
233,Spider-Man,2002,139000000,403706375,821706375,682706375,4.91,1
234,Watchmen,2009,138000000,107509799,186976250,48976250,0.35,0
235,Stealth,2005,138000000,32116746,76416746,-61583254,-0.45,0
236,The Incredible Hulk,2008,137500000,134806913,265573859,128073859,0.93,0
237,Hulk,2003,137000000,132177234,245031679,108031679,0.79,0
238,Final Fantasy: The Spirits Within,2001,137000000,32131830,85131830,-51868170,-0.38,0
239,"The Twilight Saga: Breaking Dawn, Part 2",2012,136200000,292324737,829724737,693524737,5.09,1
240,The Croods,2013,135000000,187168425,573068425,438068425,3.24,1
241,The Revenant,2015,135000000,183637894,532938302,397938302,2.95,1
243,Rango,2011,135000000,123477607,245724600,110724600,0.82,0
244,Master and Commander: The Far Side of the World,2003,135000000,93926386,212912137,77912137,0.58,0
245,Turbo,2013,135000000,83028130,286896578,151896578,1.13,0
246,Teenage Mutant Ninja Turtles: Out of the Shadows,2016,135000000,82051601,245328374,110328374,0.82,0
247,Happy Feet Two,2011,135000000,64006466,157956466,22956466,0.17,0
248,Miami Vice,2006,135000000,63478838,163818556,28818556,0.21,0
249,The Nutcracker and the Four Realms,2018,132900000,54858851,170024300,37124300,0.28,0
250,War of the Worlds,2005,132000000,234280354,606836535,474836535,3.6,1
251,Penguins of Madagascar,2014,132000000,83350911,366942531,234942531,1.78,1
252,The Hunger Games: Catching Fire,2013,130000000,424668047,864868047,734868047,5.65,1
253,Harry Potter and the Prisoner of Azkaban,2004,130000000,249757726,794020264,664020264,5.11,1
254,The Bourne Ultimatum,2007,130000000,227471070,444043396,314043396,2.42,1
255,Ant-Man and the Wasp,2018,130000000,216648740,623144660,493144660,3.79,1
256,Kung Fu Panda,2008,130000000,215434591,631910531,501910531,3.86,1
257,Ant-Man,2015,130000000,180202163,518858449,388858449,2.99,1
258,Home,2015,130000000,177397510,385997896,255997896,1.97,1
259,Mary Poppins Returns,2018,130000000,171958438,349558438,219558438,1.69,1
260,Puss in Boots,2011,130000000,149260504,554987477,424987477,3.27,1
261,Megamind,2010,130000000,148415853,321887208,191887208,1.48,0
262,Bad Boys II,2003,130000000,138540870,273271982,143271982,1.1,0
263,Rio 2,2014,130000000,131538435,492846291,362846291,2.79,1
264,Salt,2010,130000000,118311368,290650494,160650494,1.24,0
265,Noah,2014,130000000,101200044,352831065,222831065,1.71,1
266,The Adventures of Tintin,2011,130000000,77591831,373993951,243993951,1.88,1
267,After Earth,2013,130000000,60522097,251499665,121499665,0.93,0
268,Australia,2008,130000000,49554002,215080810,85080810,0.65,0
269,R.I.P.D.,2013,130000000,33618855,79076678,-50923322,-0.39,0
270,How to Train Your Dragon: The Hidden World,2019,129000000,160799505,522189138,393189138,3.05,1
271,"The Twilight Saga: Breaking Dawn, Part 1",2011,127500000,281287133,689420051,561920051,4.41,1
272,Dinosaur,2000,127500000,137748063,356148063,228648063,1.79,1
273,Logan,2017,127000000,226277068,614228432,487228432,3.84,1
274,Night at the Museum: Secret of the Tomb,2014,127000000,113746621,353756621,226756621,1.79,1
275,Harry Potter and the Deathly Hallows: Part II,2011,125000000,381193157,1341656673,1216656673,9.73,1
276,The Hunger Games: Mockingjay - Part 1,2014,125000000,337135885,766575131,641575131,5.13,1
277,Harry Potter and the Sorcererâs Stone,2001,125000000,317871467,975047606,850047606,6.8,1
278,Jumanji: The Next Level,2019,125000000,316831246,795432502,670432502,5.36,1
279,Harry Potter and the Deathly Hallows: Part I,2010,125000000,296131568,960431568,835431568,6.68,1
280,The Da Vinci Code,2006,125000000,217536138,767820459,642820459,5.14,1
281,X-Men 2,2003,125000000,214949694,406348630,281348630,2.25,1
282,Fast Five,2011,125000000,210031325,630163454,505163454,4.04,1
283,Teenage Mutant Ninja Turtles,2014,125000000,191204754,485004754,360004754,2.88,1
284,Sherlock Holmes: A Game of Shadows,2011,125000000,186848418,535663443,410663443,3.29,1
285,The Day After Tomorrow,2004,125000000,186740799,555840117,430840117,3.45,1
286,The Boss Baby,2017,125000000,175003033,527965936,402965936,3.22,1
287,Clash of the Titans,2010,125000000,163214888,493214888,368214888,2.95,1
288,Trolls,2016,125000000,153707064,344150134,219150134,1.75,1
290,Prometheus,2012,125000000,126477084,402448265,277448265,2.22,1
291,The Bourne Legacy,2012,125000000,113203870,280355920,155355920,1.24,0
293,Skyscraper,2018,125000000,68420120,304868961,179868961,1.44,0
294,The Call of the Wild,2020,125000000,62342368,107387069,-17612931,-0.14,0
295,Total Recall,2012,125000000,58877969,211856088,86856088,0.69,0
296,Assassinâs Creed,2016,125000000,54647948,240759682,115759682,0.93,0
297,Monster Trucks,2016,125000000,33370166,61642798,-63357202,-0.51,0
299,How the Grinch Stole Christmas,2000,123000000,260044825,345141403,222141403,1.81,1
300,Mission: Impossible 2,2000,120000000,215409889,549588516,429588516,3.58,1
301,The Perfect Storm,2000,120000000,182618434,328711434,208711434,1.74,1
302,Jason Bourne,2016,120000000,162192920,416168316,296168316,2.47,1
303,Fantastic Four: Rise of the Silver Surfer,2007,120000000,131921738,289480691,169480691,1.41,0
304,Life of Pi,2012,120000000,124987022,619310368,499310368,4.16,1
305,Ghost Rider,2007,120000000,115802596,229545589,109545589,0.91,0
306,Rampage,2018,120000000,101028233,428028233,308028233,2.57,1
307,Charlie's Angels: Full Throttle,2003,120000000,100814328,227163273,107163273,0.89,0
308,Elysium,2013,120000000,93050117,286192091,166192091,1.38,0
309,Oblivion,2013,120000000,89107235,287916633,167916633,1.4,0
310,Power Rangers,2017,120000000,85364450,142531552,22531552,0.19,0
311,Stuart Little 2,2002,120000000,64956806,166000000,46000000,0.38,0
312,RoboCop,2014,120000000,58607007,242981799,122981799,1.02,0
313,The Chronicles of Riddick,2004,120000000,57712751,107212751,-12787249,-0.11,0
314,The Fantastic Four,2015,120000000,56117548,167849187,47849187,0.4,0
315,Speed Racer,2008,120000000,43945766,93394462,-26605538,-0.22,0
316,The Island,2005,120000000,35818913,163018913,43018913,0.36,0
317,How Do You Know?,2010,120000000,30212620,49628177,-70371823,-0.59,0
318,Knight and Day,2010,117000000,76423035,258751370,141751370,1.21,0
319,Venom,2018,116000000,213511408,853628605,737628605,6.36,1
321,Star Wars Ep. III: Revenge of the Sith,2005,115000000,380270577,848998877,733998877,6.38,1
322,Star Wars Ep. II: Attack of the Clones,2002,115000000,310676740,656695615,541695615,4.71,1
323,"Monsters, Inc.",2001,115000000,289423425,559757719,444757719,3.87,1
324,The Wolverine,2013,115000000,132556852,416456852,301456852,2.62,1
326,The Huntsman: Winterâs War,2016,115000000,48003015,165149302,50149302,0.44,0
327,Windtalkers,2002,115000000,40914068,77628265,-37371735,-0.32,0
328,AstÃ©rix aux Jeux Olympiques,2008,113500000,999811,132999811,19499811,0.17,0
329,Gulliver's Travels,2010,112000000,42779261,232017848,120017848,1.07,0
330,Ferdinand,2017,111000000,84410380,289838913,178838913,1.61,1
331,Deadpool 2,2018,110000000,324591735,786680557,676680557,6.15,1
332,Gravity,2013,110000000,274092705,693698673,583698673,5.31,1
333,Night at the Museum,2006,110000000,250863268,579446407,469446407,4.27,1
334,Mr. and Mrs. Smith,2005,110000000,186336279,486124090,376124090,3.42,1
335,San Andreas,2015,110000000,155190832,456258539,346258539,3.15,1
336,The Smurfs,2011,110000000,142614158,563749323,453749323,4.12,1
337,Live Free or Die Hard,2007,110000000,134529403,382288147,272288147,2.48,1
338,The Divergent Series: Insurgent,2015,110000000,130179072,295075882,185075882,1.68,1
339,Ocean's Twelve,2004,110000000,125531634,362989076,252989076,2.3,1
341,The Patriot,2000,110000000,113330342,215300000,105300000,0.96,0
342,300: Rise of an Empire,2014,110000000,106580051,330780051,220780051,2.01,1
343,The Aviator,2004,110000000,102608827,208370892,98370892,0.89,0
344,Passengers,2016,110000000,100014699,302239672,192239672,1.75,1
345,The Green Hornet,2011,110000000,98780042,229155503,119155503,1.08,0
346,Miss Peregrineâs Home for Peculiar Children,2016,110000000,87242834,295986876,185986876,1.69,1
347,Real Steel,2011,110000000,85463309,263880341,153880341,1.4,0
348,Men in Black: International,2019,110000000,80001807,252994560,142994560,1.3,0
349,The A-Team,2010,110000000,77222099,177241171,67241171,0.61,0
350,The Smurfs 2,2013,110000000,71017784,348547523,238547523,2.17,1
351,The Divergent Series: Allegiant,2016,110000000,66184051,172022517,62022517,0.56,0
352,The Taking of Pelham 123,2009,110000000,65452312,152364370,42364370,0.39,0
353,Ender's Game,2013,110000000,61737191,127983283,17983283,0.16,0
354,Home on the Range,2004,110000000,50026353,76482461,-33517539,-0.3,0
356,Kingdom of Heaven,2005,110000000,47398413,218853353,108853353,0.99,0
357,Ghost in the Shell,2017,110000000,40563557,167910690,57910690,0.53,0
358,Around the World in 80 Days,2004,110000000,24004159,72004159,-37995841,-0.35,0
359,The Lord of the Rings: The Fellowship of the Ring,2001,109000000,315544750,887210985,778210985,7.14,1
360,The Cat in the Hat,2003,109000000,101018283,133818283,24818283,0.23,0
361,Ali,2001,109000000,58183966,87683966,-21316034,-0.2,0
362,The Martian,2015,108000000,228433663,655271443,547271443,5.07,1
363,Allied,2016,106000000,40098064,119266661,13266661,0.13,0
364,"I, Robot",2004,105000000,144801023,348629585,243629585,2.32,1
366,The Princess and the Frog,2009,105000000,104400899,270997378,165997378,1.58,1
367,"10,000 B.C.",2008,105000000,94784201,269065678,164065678,1.56,1
368,Ice Age: Collision Course,2016,105000000,64063008,402156682,297156682,2.83,1
369,Town &amp; Country,2001,105000000,6712451,10364769,-94635231,-0.9,0
370,Kingsman: The Golden Circle,2017,104000000,100234838,408803696,304803696,2.93,1
371,Gone in 60 Seconds,2000,103300000,101643008,232643008,129343008,1.25,0
372,Gladiator,2000,103000000,187683805,457683805,354683805,3.44,1
373,The Hangover 3,2013,103000000,112200072,362000072,259000072,2.51,1
374,A Wrinkle in Time,2018,103000000,100478608,133401882,30401882,0.3,0
375,Public Enemies,2009,102500000,97104620,212282709,109782709,1.07,0
376,Casino Royale,2006,102000000,167365000,594420283,492420283,4.83,1
377,Minority Report,2002,102000000,132024714,358824714,256824714,2.52,1
378,Bumblebee,2018,102000000,127195589,465195589,363195589,3.56,1
379,Cloud Atlas,2012,102000000,27108272,130673154,28673154,0.28,0
380,Harry Potter and the Chamber of Secrets,2002,100000000,262233381,879225135,779225135,7.79,1
383,Planet of the Apes,2001,100000000,180011740,362211740,262211740,2.62,1
384,National Treasure,2004,100000000,173005002,331323410,231323410,2.31,1
385,Django Unchained,2012,100000000,162805434,449841566,349841566,3.5,1
386,1917,2019,100000000,159227644,358403321,258403321,2.58,1
387,Little Fockers,2010,100000000,148438600,310650574,210650574,2.11,1
389,American Gangster,2007,100000000,130164645,267985456,167985456,1.68,1
390,Cloudy with a Chance of Meatballs,2009,100000000,124870275,236827677,136827677,1.37,0
391,The Other Guys,2010,100000000,119219978,170936470,70936470,0.71,0
392,Lemony Snicket's A Series of Unfortunate Events,2004,100000000,118627117,212956024,112956024,1.13,0
393,The Wolf of Wall Street,2013,100000000,116949183,389918903,289918903,2.9,1
394,Epic,2013,100000000,107518682,262794441,162794441,1.63,1
397,The Emperor's New Groove,2000,100000000,89296573,169296573,69296573,0.69,0
398,The Expendables 2,2012,100000000,85028192,311979256,211979256,2.12,1
399,Where the Wild Things Are,2009,100000000,77233467,99123656,-876344,-0.01,0
400,Eragon,2006,100000000,75030163,249488115,149488115,1.49,0
401,Hercules,2014,100000000,72688614,243388614,143388614,1.43,0
402,The Tourist,2010,100000000,67631157,278731369,178731369,1.79,1
404,Spies in Disguise,2019,100000000,66757013,166083937,66083937,0.66,0
405,The Stepford Wives,2004,100000000,59475623,96150482,-3849518,-0.04,0
406,Surf's Up,2007,100000000,58867694,145395745,45395745,0.45,0
407,Blood Diamond,2006,100000000,57377916,171377916,71377916,0.71,0
408,Midway,2019,100000000,56846802,124968126,24968126,0.25,0
409,Legend of the Guardians: The Owls of Ga'Hoole,2010,100000000,55675313,139716717,39716717,0.4,0
411,Land of the Lost,2009,100000000,49438370,69548641,-30451359,-0.3,0
412,Peter Pan,2003,100000000,48417850,95255485,-4744515,-0.05,0
413,Wonder Park,2019,100000000,45216793,115115984,15115984,0.15,0
414,Catwoman,2004,100000000,40202379,82145379,-17854621,-0.18,0
415,The Expendables 3,2014,100000000,39322544,209461378,109461378,1.09,0
416,Treasure Planet,2002,100000000,38120554,91800000,-8200000,-0.08,0
417,Green Zone,2010,100000000,35497337,97523020,-2476980,-0.02,0
418,Geostorm,2017,100000000,33700160,220796009,120796009,1.21,0
419,Point Break,2015,100000000,28782481,126704591,26704591,0.27,0
420,Cats,2019,100000000,27166770,75479413,-24520587,-0.25,0
421,In the Heart of the Sea,2015,100000000,25020758,89693309,-10306691,-0.1,0
422,Transcendence,2014,100000000,23022309,103039258,3039258,0.03,0
423,Son of the Mask,2005,100000000,17018422,59918422,-40081578,-0.4,0
424,Mortal Engines,2018,100000000,15951040,85287417,-14712583,-0.15,0
425,The Adventures of Pluto Nash,2002,100000000,4411102,7094995,-92905005,-0.93,0
426,Jin lÃ­ng shÃ­ san chai,2012,100000000,311434,98227017,-1772983,-0.02,0
428,The Peanuts Movie,2015,99000000,130178411,250091610,151091610,1.53,1
429,The LEGO Movie 2: The Second Part,2019,99000000,105806508,190131036,91131036,0.92,0
430,Robin Hood,2018,99000000,30824628,85210012,-13789988,-0.14,0
431,The Mummy Returns,2001,98000000,202007640,435040395,337040395,3.44,1
432,Ford v. Ferrari,2019,97600000,117624357,224451702,126851702,1.3,0
433,Gangs of New York,2002,97000000,77730500,183124621,86124621,0.89,0
434,Alien: Covenant,2017,97000000,74262031,238521247,141521247,1.46,0
435,Cinderella,2015,95000000,201151353,534551353,439551353,4.63,1
436,Ice Age: Continental Drift,2012,95000000,161321843,879765137,784765137,8.26,1
437,Black Hawk Down,2001,95000000,108638745,159691085,64691085,0.68,0
438,Sex and the City 2,2010,95000000,95347692,294680778,199680778,2.1,1
439,Percy Jackson &amp; the Olympians: The Lightning Thief,2010,95000000,88768303,223050874,128050874,1.35,0
440,The Campaign,2012,95000000,86907746,104907746,9907746,0.1,0
441,Unstoppable,2010,95000000,81562942,165720921,70720921,0.74,0
443,The Road to El Dorado,2000,95000000,50802661,65700000,-29300000,-0.31,0
444,The Lovely Bones,2009,95000000,44114232,94894448,-105552,-0.0,0
445,Ben-Hur,2016,95000000,26410477,91669648,-3330352,-0.04,0
446,Seventh Son,2014,95000000,17725785,108874967,13874967,0.15,0
447,Finding Nemo,2003,94000000,380529370,936181011,842181011,8.96,1
448,The Lord of the Rings: The Return of the King,2003,94000000,377845905,1120224046,1026224046,10.92,1
449,The Lord of the Rings: The Two Towers,2002,94000000,342548984,927598249,833598249,8.87,1
450,Lara Croft: Tomb Raider,2001,94000000,131144183,273330185,179330185,1.91,1
451,Kingsman: The Secret Service,2015,94000000,128261724,404561724,310561724,3.3,1
452,Jurassic Park III,2001,93000000,181166115,365900000,272900000,2.93,1
453,Rise of the Planet of the Apes,2011,93000000,176760185,470986200,377986200,4.06,1
454,The Spiderwick Chronicles,2008,92500000,71195053,162839667,70339667,0.76,0
455,The Incredibles,2004,92000000,261441092,631441092,539441092,5.86,1
456,A Good Day to Die Hard,2013,92000000,67349198,304249198,212249198,2.31,1
457,The Alamo,2004,92000000,22406362,23911362,-68088638,-0.74,0
459,The Secret Life of Walter Mitty,2013,91000000,58236838,187861183,96861183,1.06,0
460,Jumanji: Welcome to the Jungle,2017,90000000,404508916,964496193,874496193,9.72,1
463,Rush Hour 2,2001,90000000,226164286,347425832,257425832,2.86,1
464,Sherlock Holmes,2009,90000000,209028679,498438212,408438212,4.54,1
465,Bad Boys For Life,2020,90000000,204417855,418047493,328047493,3.64,1
466,Ice Age: Dawn of the Dinosaurs,2009,90000000,196573705,859701857,769701857,8.55,1
467,Spider-Man: Into The Spider-Verse 3D,2018,90000000,190173195,374551021,284551021,3.16,1
468,What Lies Beneath,2000,90000000,155464351,288693989,198693989,2.21,1
469,Sonic The Hedgehog,2020,90000000,146066470,306011347,216011347,2.4,1
470,Rio,2011,90000000,143619809,487519809,397519809,4.42,1
471,Once Upon a Timeâ¦in Hollywood,2019,90000000,142502728,374580405,284580405,3.16,1
472,The Departed,2006,90000000,132384315,289660619,199660619,2.22,1
473,Charlie's Angels,2000,90000000,125305545,259736090,169736090,1.89,1
475,Tropic Thunder,2008,90000000,110515313,191145256,101145256,1.12,0
476,The Girl with the Dragon Tattoo,2011,90000000,102515793,239373970,149373970,1.66,1
478,You Don't Mess With the Zohan,2008,90000000,100018837,202910991,112910991,1.25,0
480,The Magnificent Seven,2016,90000000,93432655,162525156,72525156,0.81,0
481,Alvin and the Chipmunks: The Road Chip,2015,90000000,85886987,249517956,159517956,1.77,1
482,Atlantis: The Lost Empire,2001,90000000,84052762,186049020,96049020,1.07,0
483,Valkyrie,2008,90000000,83107829,203932174,113932174,1.27,0
484,Pixels,2015,90000000,78765986,244041804,154041804,1.71,1
485,Artificial Intelligence: AI,2001,90000000,78616689,235900000,145900000,1.62,1
486,The Haunted Mansion,2003,90000000,75817994,155750628,65750628,0.73,0
487,Hollow Man,2000,90000000,73209340,191200000,101200000,1.12,0
488,The Interpreter,2005,90000000,72708161,162753837,72753837,0.81,0
489,Percy Jackson: Sea of Monsters,2013,90000000,68559554,200859554,110859554,1.23,0
490,Lara Croft: Tomb Raider: The Cradle of Life,2003,90000000,65653758,157092943,67092943,0.75,0
491,Now You See Me 2,2016,90000000,65075540,328325007,238325007,2.65,1
492,Spy Game,2001,90000000,62362560,143049560,53049560,0.59,0
494,Mission to Mars,2000,90000000,60874615,106000000,16000000,0.18,0
495,Tomb Raider,2018,90000000,58250803,273477501,183477501,2.04,1
497,King Arthur,2004,90000000,51877963,203653524,113653524,1.26,0
500,K-19: The Widowmaker,2002,90000000,35168966,65716126,-24283874,-0.27,0
501,Conan the Barbarian,2011,90000000,21295021,63356133,-26643867,-0.3,0
502,The Three Musketeers,2011,90000000,20377913,139877913,49877913,0.55,0
503,The Promise,2017,90000000,8224288,10551417,-79448583,-0.88,0
504,The Nutcracker in 3D,2010,90000000,195459,20466016,-69533984,-0.77,0
507,Twister,2005,88000000,241688385,495700000,407700000,4.63,1
508,Cinderella Man,2018,88000000,61649911,105021488,17021488,0.19,0
509,The Predator,2005,88000000,51024708,159487563,71487563,0.81,0
510,Fantastic Four,2001,87500000,154696080,333132750,245632750,2.81,1
511,Hannibal,2003,87000000,165092266,350100280,263100280,3.02,1
512,Seabiscuit,2000,86000000,120277854,148715342,62715342,0.73,0
513,Cast Away,2006,85000000,233632142,427230516,342230516,4.03,1
514,Happy Feet,2001,85000000,198000317,385000317,300000317,3.53,1
515,Ocean's Eleven,2004,85000000,183417150,450728529,365728529,4.3,1
517,Air Force One,2009,85000000,172956409,315268353,230268353,2.71,1
518,Fast &amp; Furious,2008,85000000,155064265,363064265,278064265,3.27,1
519,Horton Hears a Who,2014,85000000,154529439,299477886,214477886,2.52,1
520,Divergent,2012,85000000,150947895,276014965,191014965,2.25,1
521,Hotel Transylvania,2019,85000000,148313048,378505812,293505812,3.45,1
522,Shazam!,2007,85000000,140371656,363664533,278664533,3.28,1
523,Enchanted,2012,85000000,127706877,340384141,255384141,3.0,1
524,Safe House,2007,85000000,126181630,208542162,123542162,1.45,0
525,I Now Pronounce You Chuck and Larry,2007,85000000,119725280,185708462,100708462,1.18,0
526,Ocean's Thirteen,2009,85000000,117144465,311744465,226744465,2.67,1
528,Enemy of the State,2006,85000000,111549836,250649836,165649836,1.95,1
529,Open Season,2011,85000000,85105259,191932158,106932158,1.26,0
530,Tower Heist,2000,85000000,78046570,150422946,65422946,0.77,0
531,102 Dalmatians,2012,85000000,66941559,66941559,-18058441,-0.21,0
532,Mirror Mirror,2006,85000000,64935167,173613482,88613482,1.04,0
533,The Holiday,2006,85000000,63280000,205190324,120190324,1.41,0
534,The Fast and the Furious: Tokyo Drift,2005,85000000,62615510,157794205,72794205,0.86,0
535,Memoirs of a Geisha,2001,85000000,57010853,161510853,76510853,0.9,0
537,Last Action Hero,2003,85000000,50016394,137298489,52298489,0.62,0
538,The Rundown,2011,85000000,47641743,80831893,-4168107,-0.05,0
539,Arthur Christmas,2017,85000000,46462469,149717124,64717124,0.76,0
541,Meet Joe Black,2010,85000000,44650003,44650003,-40349997,-0.47,0
542,Cats &amp; Dogs: The Revenge of Kitty Galore,2002,85000000,43585753,113026383,28026383,0.33,0
543,Collateral Damage,2002,85000000,40048332,78353508,-6646492,-0.08,0
545,Judge Dredd,2007,85000000,34687912,113487912,28487912,0.34,0
546,Zodiac,2010,85000000,33080084,83080084,-1919916,-0.02,0
547,Scott Pilgrim vs. The World,2003,85000000,31611316,48056764,-36943236,-0.43,0
549,Father's Day,2017,85000000,28681080,35681080,-49318920,-0.58,0
550,The Greatest Showman,2002,84000000,174340174,440273236,356273236,4.24,1
551,Scooby-Doo,2000,84000000,153294164,276294164,192294164,2.29,1
552,Nutty Professor II: The Klumps,2013,84000000,123307945,166307945,82307945,0.98,0
553,RED 2,2006,84000000,53262560,141507355,57507355,0.68,0
554,Click,2006,82500000,137355633,237685089,155185089,1.88,1
555,Charlotte's Web,2008,82500000,82985708,143985708,61485708,0.75,0
556,Jumper,2008,82500000,80172128,222640812,140140812,1.7,1
557,Hellboy II: The Golden Army,2005,82500000,75986503,160388063,77888063,0.94,0
558,The Longest Yard,2010,82000000,158119460,191558505,109558505,1.34,0
559,The Expendables,2020,82000000,103068524,268268174,186268174,2.27,1
560,Birds of Prey (And the Fantabulous Emancipation…,2000,82000000,84158461,201716850,119716850,1.46,0
561,The 6th Day,2003,82000000,34543701,96024898,14024898,0.17,0
562,Bruce Almighty,2012,81000000,242704995,484468608,403468608,4.98,1
563,The Hunger Games,2011,80000000,408010692,677923379,597923379,7.47,1
565,Mission: Impossible,2017,80000000,180981886,457697994,377697994,4.72,1
566,The Lego Batman Movie,2015,80000000,175750384,310660018,230660018,2.88,1
568,Batman Returns,2019,80000000,162833635,266824291,186824291,2.34,1
570,The Mummy,2006,80000000,155385488,416385488,336385488,4.2,1
571,Over the Hedge,2002,80000000,155019340,343397247,263397247,3.29,1
573,Deep Impact,2013,80000000,140464664,349464664,269464664,3.37,1
574,Grown Ups 2,2011,80000000,133668525,247023808,167023808,2.09,1
575,Alvin and the Chipmunks: Chipwrecked,2008,80000000,133107389,349088523,269088523,3.36,1
576,Get Smart,2005,80000000,130319208,226739416,146739416,1.83,1
577,Robots,2010,80000000,128200012,260700012,180700012,2.26,1
578,Shutter Island,2003,80000000,128012934,299461782,219461782,2.74,1
579,Something's Gotta Give,2008,80000000,124685242,266685242,186685242,2.33,1
581,Face/Off,2008,80000000,112276146,241200000,161200000,2.02,1
582,Bedtime Stories,2002,80000000,110101975,221468935,141468935,1.77,1
583,Road to Perdition,2011,80000000,104054514,183354514,103354514,1.29,0
584,Just Go With It,2003,80000000,103028109,214974953,134974953,1.69,1
585,Daredevil,2008,80000000,102543518,182782518,102782518,1.28,0
587,Con Air,2010,80000000,101117573,224117573,144117573,1.8,1
588,Yogi Bear,2003,80000000,100246011,204774690,124774690,1.56,1
589,Cold Mountain,2010,80000000,95632614,165173909,85173909,1.06,0
593,Space Jam,2014,80000000,90463534,250180384,170180384,2.13,1
594,Fury,2018,80000000,85817906,210315681,130315681,1.63,1
595,Smallfoot,2006,80000000,83240103,213682073,133682073,1.67,1
596,The Pink Panther,2011,80000000,82226474,158926474,78926474,0.99,0
597,Zookeeper,2008,80000000,80360866,170805525,90805525,1.14,0
600,"Six Days, Seven Nights",2002,80000000,74339294,164800000,84800000,1.06,0
601,Spirit: Stallion of the Cimarron,2001,80000000,73215310,106515310,26515310,0.33,0
604,Lost In Space,2004,80000000,69117629,136047317,56047317,0.7,0
605,The Manchurian Candidate,2006,80000000,65948711,96148711,16148711,0.2,0
606,DÃ©jÃ  Vu,2005,80000000,64038616,181038616,101038616,1.26,0
607,Bewitched,2002,80000000,63313159,131159306,51159306,0.64,0
610,Mighty Joe Young,2019,80000000,50632037,50632037,-29367963,-0.37,0
611,Ad Astra,2005,80000000,50188370,135432019,55432019,0.69,0
612,The Legend of Zorro,2000,80000000,45575336,141475336,61475336,0.77,0
613,Little Nicky,2009,80000000,39442871,58270391,-21729609,-0.27,0
614,Surrogates,2001,80000000,38577772,119668350,39668350,0.5,0
615,Evolution,2005,80000000,38311134,98341932,18341932,0.23,0
617,Mars Attacks!,2006,80000000,37771017,101371017,21371017,0.27,0
618,The Wild,2013,80000000,37384046,99010667,19010667,0.24,0
619,Walking with Dinosaurs,2000,80000000,36076121,123368842,43368842,0.54,0
621,Daylight,2015,80000000,32908290,158908290,78908290,0.99,0
622,The Last Witch Hunter,2014,80000000,27367660,130818912,50818912,0.64,0
623,Pompeii,2000,80000000,23169033,108469033,28469033,0.36,0
624,Battlefield Earth: A Saga of the Year 3000,2003,80000000,21471685,29725663,-50274337,-0.63,0
625,Looney Tunes: Back in Action,2009,80000000,20950820,54540662,-25459338,-0.32,0
626,Nine,2003,80000000,19676965,56984219,-23015781,-0.29,0
627,Timeline,2010,80000000,19480739,26703184,-53296816,-0.67,0
630,The Postman,2000,80000000,17650704,20841123,-59158877,-0.74,0
631,Red Planet,2007,80000000,17480890,33463969,-46536031,-0.58,0
632,Arthur et les Minimoys,2007,80000000,15132763,113325743,33325743,0.42,0
633,The Invasion,2005,80000000,15074191,40147042,-39852958,-0.5,0
634,A Sound of Thunder,2019,80000000,1900451,6300451,-73699549,-0.92,0
636,The Lion King,2012,79300000,421785283,986214868,906914868,11.44,1
637,Journey 2: The Mysterious Island,2011,79000000,103860290,318146162,239146162,3.03,1
638,Jack and Jill,2001,79000000,74158157,150519217,71519217,0.91,0
639,A Beautiful Mind,2013,78000000,170708996,317668058,239668058,3.07,1
640,Cloudy with a Chance of Meatballs 2,2002,78000000,119793567,274392649,196392649,2.52,1
641,Red Dragon,2004,78000000,92955420,206455420,128455420,1.65,1
642,Hidalgo,2003,78000000,67286731,108086731,30086731,0.39,0
643,The League of Extraordinary Gentlemen,2004,78000000,66465204,179265204,101265204,1.3,0
644,Exorcist: The Beginning,2012,78000000,41814863,43957541,-34042459,-0.44,0
645,AstÃ©rix et ObÃ©lix: Au service de Sa MajestÃ© ,2015,77600000,0,60680125,-16919875,-0.22,0
646,The Little Prince,2017,77500000,1311213,102028919,24528919,0.32,0
648,The Equalizer 2,2013,77000000,102084362,190376181,113376181,1.47,0
649,Despicable Me 2,2003,76000000,368065385,975216835,899216835,11.83,1
650,2 Fast 2 Furious,2006,76000000,127120058,236410607,160410607,2.11,1
651,Children of Men,2000,76000000,35552383,69845011,-6154989,-0.08,0
652,The Adventures of Rocky &amp; Bullwinkle,2016,76000000,26000610,35129610,-40870390,-0.54,0
654,Independence Day,2018,75000000,306169255,817400878,742400878,9.9,1
655,Dr. Seussâ The Grinch,2016,75000000,270620950,511669509,436669509,5.82,1
656,Sing,2017,75000000,270329045,634454789,559454789,7.46,1
658,The Lost World: Jurassic Park,2006,75000000,229086679,618638999,543638999,7.25,1
659,Ice Age: The Meltdown,2005,75000000,195330621,651899282,576899282,7.69,1
660,Madagascar,2010,75000000,193595521,556559566,481559566,6.42,1
661,Grown Ups,2004,75000000,162001186,272223430,197223430,2.63,1
662,Shark Tale,2000,75000000,161412000,371917043,296917043,3.96,1
663,X-Men,2008,75000000,157299717,296872367,221872367,2.96,1
665,The Rock,2004,75000000,134069511,336069511,261069511,3.48,1
666,50 First Dates,2018,75000000,120776832,196320329,121320329,1.62,1
667,Mamma Mia: Here We Go Again!,2007,75000000,120634935,395414125,320414125,4.27,1
668,Hairspray,2013,75000000,118871849,202822861,127822861,1.7,1
669,Now You See Me,2006,75000000,117723989,342769200,267769200,3.57,1
670,Dreamgirls,2018,75000000,103365956,155708695,80708695,1.08,0
672,Inspector Gadget,2011,75000000,97387965,97387965,22387965,0.3,0
673,Immortals,2004,75000000,83504017,211562435,136562435,1.82,1
674,The Terminal,2005,75000000,77073959,218673959,143673959,1.92,1
675,Constantine,2006,75000000,75976178,221594911,146594911,1.95,1
676,Monster House,2000,75000000,73661010,141267370,66267370,0.88,0
677,Vertical Limit,2007,75000000,68473360,213500000,138500000,1.85,1
679,Life,2019,75000000,64062587,73521587,-1478413,-0.02,0
680,Abominable,2005,75000000,60716390,184327350,109327350,1.46,0
681,Be Cool,2005,75000000,55849401,94944017,19944017,0.27,0
682,Munich,2010,75000000,47379090,131492772,56492772,0.75,0
683,Killers,2015,75000000,47059963,95572749,20572749,0.27,0
684,The Man From U.N.C.L.E.,2003,75000000,45445109,108517735,33517735,0.45,0
685,Tears of the Sun,2006,75000000,43632458,85632458,10632458,0.14,0
686,Lady in the Water,2004,75000000,42285169,72785169,-2214831,-0.03,0
687,Spanglish,2001,75000000,42044321,54344321,-20655679,-0.28,0
690,First Knight,2011,75000000,37361412,127361412,52361412,0.7,0
691,Sucker Punch,2005,75000000,36392502,89758389,14758389,0.2,0
692,Hostage,2016,75000000,34636443,77636443,2636443,0.04,0
693,Inferno,2003,75000000,34343574,219519367,144519367,1.93,1
694,Hollywood Homicide,2000,75000000,30207785,50409753,-24590247,-0.33,0
695,Titan A.E.,2004,75000000,22751979,36751979,-38248021,-0.51,0
698,Virus,2001,75000000,14010690,30626690,-44373310,-0.59,0
700,PLAYMOBIL,2021,75000000,1115008,16283165,-58716835,-0.78,0
702,Minions,2015,74000000,336045770,1159631140,1085631140,14.67,1
703,The SpongeBob Movie: Sponge Out of Water,2000,74000000,162994032,311013181,237013181,3.2,1
704,Unbreakable,2006,73243106,94999143,248099143,174856037,2.39,1
705,Talladega Nights: The Ballad of Ricky Bobby,2016,73000000,148213377,162870525,89870525,1.23,0
708,Sphere,2007,73000000,37068294,50168294,-22831706,-0.31,0
709,The Simpsons Movie,2008,72500000,183135014,527071022,454571022,6.27,1
710,Fool's Gold,2009,72500000,70231041,109362966,36862966,0.51,0
711,Funny People,2007,72500000,51855045,71880305,-619695,-0.01,0
712,The Kingdom,2001,72500000,47467250,86802457,14302457,0.2,0
714,Braveheart,2005,72000000,75545647,209045244,137045244,1.9,1
715,Jarhead,2001,72000000,62647540,96947540,24947540,0.35,0
716,Driven,2001,72000000,32616869,54616869,-17383131,-0.24,0
717,The Majestic,2004,72000000,27796042,37306334,-34693666,-0.48,0
718,Two Brothers,2004,72000000,19176754,62176754,-9823246,-0.14,0
720,Doctor Dolittle,2002,71500000,144156605,294156605,222656605,3.11,1
721,Signs,2004,70702619,227969295,408250578,337547959,4.77,1
722,Shrek 2,2006,70000000,441226247,935253978,865253978,12.36,1
723,Cars,2009,70000000,244082982,461651246,391651246,5.6,1
724,Alvin and the Chipmunks: The Squeakquel,2019,70000000,219614612,443483213,373483213,5.34,1
727,Runaway Bride,2002,70000000,152257509,310138178,240138178,3.43,1
728,xXx,2018,70000000,141930000,267200000,197200000,2.82,1
730,Ransom,2009,70000000,136492681,308700000,238700000,3.41,1
733,Die Hard 2,2003,70000000,117323878,239814025,169814025,2.43,1
734,S.W.A.T.,2017,70000000,116877597,207154748,137154748,1.96,1
736,Sleepy Hollow,2001,70000000,101068340,207068340,137068340,1.96,1
738,Hercules,2013,70000000,99112101,250700000,180700000,2.58,1
739,Olympus Has Fallen,2011,70000000,98927592,172878928,102878928,1.47,0
740,Battle: Los Angeles,2004,70000000,83552429,213463976,143463976,2.05,1
741,AVP: Alien Vs. Predator,2011,70000000,80281096,172543519,102543519,1.46,0
742,War Horse,2002,70000000,79883359,156815529,86815529,1.24,0
743,We Were Soldiers,2014,70000000,78120196,114658262,44658262,0.64,0
744,The Monuments Men,2016,70000000,78031620,158702748,88702748,1.27,0
746,Star Trek: Insurrection,2003,70000000,70187658,117800000,47800000,0.68,0
748,Wolf,2012,70000000,65011757,131011757,61011757,0.87,0
749,Underworld: Awakening,2017,70000000,62321039,160379930,90379930,1.29,0
750,The Lego Ninjago Movie,2014,70000000,59281555,122737201,52737201,0.75,0
751,Dracula Untold,2006,70000000,55991880,220241723,150241723,2.15,1
753,The Abyss,2010,70000000,54243125,54243125,-15756875,-0.23,0
754,Wall Street 2: Money Never Sleeps,2011,70000000,52474616,137431619,67431619,0.96,0
755,The Dilemma,2005,70000000,48475290,70546865,546865,0.01,0
757,The Siege,2007,70000000,40934175,116625798,46625798,0.67,0
758,Stardust,2012,70000000,38634938,137022245,67022245,0.96,0
760,Seven Years in Tibet,2004,70000000,37945884,131445884,61445884,0.88,0
761,Sky Captain and the World of Tomorrow,2007,70000000,37760080,49730854,-20269146,-0.29,0
762,The Brave One,2002,70000000,36793804,69792704,-207296,-0.0,0
763,I Spy,2002,70000000,33561137,60279822,-9720178,-0.14,0
764,Bad Company,2005,70000000,30157016,69157016,-842984,-0.01,0
765,Doom,2016,70000000,28212337,58757178,-11242822,-0.16,0
766,The Finest Hours,2013,70000000,27569558,49252761,-20747239,-0.3,0
767,Escape Plan,2011,70000000,25135965,103735965,33735965,0.48,0
769,Hard Rain,2002,70000000,19870567,19870567,-50129433,-0.72,0
770,Hart's War,2002,70000000,19076815,33076815,-36923185,-0.53,0
771,Rollerball,2014,70000000,18990542,25852508,-44147492,-0.63,0
772,The Legend of Hercules,2007,70000000,18848538,58953319,-11046681,-0.16,0
773,Next,2002,70000000,18211013,73591500,3591500,0.05,0
774,Ballistic: Ecks vs. Sever,2001,70000000,14294842,14294842,-55705158,-0.8,0
775,Osmosis Jones,2014,70000000,13596911,13596911,-56403089,-0.81,0
776,Legends of Oz: Dorothyâs Return,2015,70000000,8462347,20107933,-49892067,-0.71,0
777,Blackhat,2006,70000000,8005980,19665004,-50334996,-0.72,0
778,Basic Instinct 2,2010,70000000,5946136,35417162,-34582838,-0.49,0
779,Agora,2010,70000000,619423,38992292,-31007708,-0.44,0
781,Despicable Me,2018,69000000,251513985,543464573,474464573,6.88,1
782,Dinner for Schmucks,2010,69000000,73026337,86796502,17796502,0.26,0
783,Red Sparrow,2002,69000000,46874505,145951861,76951861,1.12,0
784,The Twilight Saga: Eclipse,2015,68000000,300531751,706102828,638102828,9.38,1
785,The Sum of All Fears,2001,68000000,118471320,193500000,125500000,1.85,1
786,Ted 2,2011,68000000,81476385,217214143,149214143,2.19,1
788,Hall Pass,2003,68000000,45060734,87173475,19173475,0.28,0
791,Mystery Men,2017,68000000,29762011,33462011,-34537989,-0.51,0
792,The Insider,2012,68000000,28965197,60265197,-7734803,-0.11,0
793,Downsizing,2008,68000000,24449754,54462971,-13537029,-0.2,0
794,Doctor Seuss' The Lorax,2012,67500000,214030500,350976753,283476753,4.2,1
796,Abraham Lincoln: Vampire Hunter,2007,67500000,37519139,137489730,69989730,1.04,0
799,Entrapment,2014,66000000,87707396,211700000,145700000,2.21,1
801,Need for Speed,2000,66000000,43568507,194169619,128169619,1.94,1
802,Saving Private Ryan,2012,65000000,216335085,485035085,420035085,6.46,1
803,What Women Want,2002,65000000,182805123,374105123,309105123,4.76,1
806,Apollo 13,2018,65000000,173772767,335802271,270802271,4.17,1
807,The Matrix,2012,65000000,173396389,465421959,400421959,6.16,1
808,Hotel Transylvania 3: Summer Vacation,2002,65000000,167500092,527093622,462093622,7.11,1
811,Total Recall,2014,65000000,119394839,261400000,196400000,3.02,1
812,You've Got Mail,2015,65000000,115821495,250800000,185800000,2.86,1
813,Unbroken,2010,65000000,115637895,163527824,98527824,1.52,1
814,Spy!,2008,65000000,110825712,232585748,167585748,2.58,1
817,Jumanji,2000,65000000,100458310,262758310,197758310,3.04,1
818,The Mask of Zorro,2014,65000000,93828745,233700000,168700000,2.6,1
820,Annie,2016,65000000,85911262,139829625,74829625,1.15,0
822,Peteâs Dragon,2006,65000000,76233151,137768975,72768975,1.12,0
823,Broken Arrow,2000,65000000,70645997,148345997,83345997,1.28,0
824,World Trade Center,2003,65000000,70278893,163295654,98295654,1.51,1
825,The Kid,2012,65000000,69688384,69688384,4688384,0.07,0
827,The Dictator,2012,65000000,59650222,180148897,115148897,1.77,1
828,Eyes Wide Shut,2015,65000000,55691208,104264617,39264617,0.6,0
829,This Means War,2004,65000000,54760791,156974557,91974557,1.41,0
830,Focus,2012,65000000,53862963,168065700,103065700,1.59,1
831,Blade: Trinity,2006,65000000,52397389,131353165,66353165,1.02,0
832,Red Dawn,2015,65000000,44806783,48164150,-16835850,-0.26,0
833,We Are Marshall,2012,65000000,43545364,43545364,-21454636,-0.33,0
834,Everest,2019,65000000,43482270,221297061,156297061,2.4,1
837,Primary Colors,2008,65000000,39017984,39017984,-25982016,-0.4,0
839,Death Race,2000,65000000,36316032,72516819,7516819,0.12,0
840,The Long Kiss Goodnight,2005,65000000,33447612,33447612,-31552388,-0.49,0
841,Proof of Life,2003,65000000,32598931,62761005,-2238995,-0.03,0
842,Zathura,2005,65000000,28045540,58545540,-6454460,-0.1,0
843,The Missing,2009,65000000,26900336,38253433,-26746567,-0.41,0
844,Elektra,2014,65000000,24409722,56824633,-8175367,-0.13,0
845,Astro Boy,2019,65000000,19551067,41636243,-23363757,-0.36,0
847,Underwater,2014,65000000,17291078,39194264,-25805736,-0.4,0
848,Hudson Hawk,2016,65000000,17218916,17218916,-47781084,-0.74,0
849,Sin City: A Dame to Kill For,2000,65000000,13757804,40650842,-24349158,-0.37,0
850,Live by Night,2005,65000000,10378555,21774432,-43225568,-0.67,0
851,Lucky Numbers,2015,65000000,10014234,10014234,-54985766,-0.85,0
852,Oliver Twist,2018,65000000,2070920,26670920,-38329080,-0.59,0
853,Tian jiang xiong shi,2006,65000000,74070,122519874,57519874,0.88,0
855,Little Man,2006,64000000,58636047,101636047,37636047,0.59,0
857,Perfume: The Story of a Murderer,2002,63700000,2223293,133603463,69903463,1.1,0
858,Jurassic Park,2011,63000000,402523348,1045627627,982627627,15.6,1
859,Austin Powers in Goldmember,2017,63000000,213117789,296338663,233338663,3.7,1
862,Wyatt Earp,2000,63000000,25052000,25052000,-37948000,-0.6,0
864,U-571,2015,62000000,77086030,127630030,65630030,1.06,0
865,The American President,2008,62000000,60022813,107822813,45822813,0.74,0
866,The Hateful Eight,2001,62000000,54117416,147924595,85924595,1.39,0
867,The Love Guru,2014,62000000,32235793,40159017,-21840983,-0.35,0
868,3000 Miles to Graceland,2007,62000000,15738632,18708848,-43291152,-0.7,0
869,Gone Girl,2015,61000000,167767189,368567189,307567189,5.04,1
870,Blades of Glory,2013,61000000,118594548,145594548,84594548,1.39,0
871,Maze Runner: The Scorch Trials,2018,61000000,81697192,310566162,249566162,4.09,1
872,2 Guns,2019,61000000,75612460,132493015,71493015,1.17,0
873,Maze Runner: The Death Cure,2016,61000000,58032443,265878536,204878536,3.36,1
874,A Dogâs Way Home,2004,61000000,41952715,81152505,20152505,0.33,0
875,Mei Ren Yu,2014,60720000,3229457,554516671,493796671,8.13,1
876,Meet the Fockers,2007,60000000,279167575,516567575,456567575,7.61,1
877,The Lego Movie,2007,60000000,257784718,468084718,408084718,6.8,1
878,300,2008,60000000,210614939,454161935,394161935,6.57,1
881,The Green Mile,2016,60000000,136801374,290701374,230701374,3.85,1
882,The Truman Show,2002,60000000,125618201,264118201,204118201,3.4,1
883,Sully,2009,60000000,125070033,238524556,178524556,2.98,1
885,Couples Retreat,2003,60000000,109205660,172450423,112450423,1.87,1
886,Goldeneye,2003,60000000,106429941,356429941,296429941,4.94,1
889,The General's Daughter,2004,60000000,102705852,149705852,89705852,1.5,1
890,The Prince of Egypt,2001,60000000,101413188,218613188,158613188,2.64,1
891,Collateral,2002,60000000,100170152,217670152,157670152,2.63,1
893,Two Weeks Notice,2002,60000000,93354918,199043309,139043309,2.32,1
894,Antz,2010,60000000,90757863,152457863,92457863,1.54,1
895,The Scorpion King,2004,60000000,90580000,165890634,105890634,1.76,1
897,Starsky &amp; Hutch,2005,60000000,88200225,170200225,110200225,1.84,1
898,Days of Thunder,2010,60000000,82670733,157670733,97670733,1.63,1
899,Cheaper by the Dozen 2,2012,60000000,82571173,135015330,75015330,1.25,0
900,Eat Pray Love,2004,60000000,80574010,206598789,146598789,2.44,1
901,Jack Reacher,2000,60000000,80070736,217370736,157370736,2.62,1
902,Man on Fire,2011,60000000,77906816,130968579,70968579,1.18,0
905,Any Given Sunday,2009,60000000,75530832,100230832,40230832,0.67,0
906,The Horse Whisperer,2004,60000000,75383563,186883563,126883563,2.11,1
908,Ladder 49,2009,60000000,74541707,102332848,42332848,0.71,0
909,Deep Blue Sea,2003,60000000,73648228,165048228,105048228,1.75,1
910,Michael Jackson's This Is It,2008,60000000,72091016,252091016,192091016,3.2,1
911,Kangaroo Jack,2016,60000000,66723216,90558582,30558582,0.51,0
912,The Happening,2000,60000000,64506874,162778384,102778384,1.71,1
913,London Has Fallen,2006,60000000,62524260,195194085,135194085,2.25,1
915,The Shaggy Dog,2004,60000000,61123569,87123569,27123569,0.45,0
916,Jingle All the Way,2016,60000000,60592389,129832389,69832389,1.16,0
917,Hellboy,2017,60000000,59623958,99823958,39823958,0.66,0
920,U.S. Marshals,2015,60000000,57833603,57833603,-2166397,-0.04,0
921,A Civil Action,2012,60000000,56709981,56709981,-3290019,-0.05,0
923,ParaNorman,2003,60000000,56003051,108119662,48119662,0.8,0
925,Paycheck,2008,60000000,53789313,98819789,38819789,0.65,0
926,Up Close &amp; Personal,2014,60000000,51045801,100645801,40645801,0.68,0
927,The Tale of Despereaux,2017,60000000,50877145,90482317,30482317,0.51,0
928,The Boxtrolls,2002,60000000,50837305,111898741,51898741,0.86,0
929,The Dark Tower,2014,60000000,50701325,113461527,53461527,0.89,0
931,Jack Ryan: Shadow Recruit,2005,60000000,50577412,131377412,71377412,1.19,0
932,Under Siege 2: Dark Territory,2018,60000000,50024083,104324083,44324083,0.74,0
934,Vice,2007,60000000,47836282,70893782,10893782,0.18,0
936,Shooter,2013,60000000,47003582,95538560,35538560,0.59,0
937,Practical Magic,2017,60000000,46850558,68336997,8336997,0.14,0
938,Gangster Squad,2018,60000000,46000903,104100903,44100903,0.74,0
939,Smurfs: The Lost Village,2009,60000000,45020282,197578586,137578586,2.29,1
940,First Man,2010,60000000,44936545,105703325,45703325,0.76,0
941,Year One,2002,60000000,43337279,57604723,-2395277,-0.04,0
942,Edge of Darkness,2002,60000000,43313890,82812456,22812456,0.38,0
943,Star Trek: Nemesis,2009,60000000,43254409,67312826,7312826,0.12,0
944,Reign of Fire,2009,60000000,43061982,82150183,22150183,0.37,0
945,Planet 51,2008,60000000,42194060,108996113,48996113,0.82,0
946,Duplicity,2009,60000000,40572825,81079566,21079566,0.35,0
947,Righteous Kill,2009,60000000,40081410,78481410,18481410,0.31,0
949,State of Play,2006,60000000,37017955,88832210,28832210,0.48,0
950,My Favorite Martian,2012,60000000,36850101,36850101,-23149899,-0.39,0
951,The Sentinel,2003,60000000,36280697,78080697,18080697,0.3,0
954,The Relic,2000,60000000,33956608,33956608,-26043392,-0.43,0
955,Mercury Rising,2019,60000000,32983332,32983332,-27016668,-0.45,0
956,Almost Famous,2002,60000000,32522352,47371191,-12628809,-0.21,0
957,Cold Pursuit,2009,60000000,32138862,62599159,2599159,0.04,0
958,Analyze That,2013,60000000,32122249,54994757,-5005243,-0.08,0
959,The Soloist,2000,60000000,31853584,38522450,-21477550,-0.36,0
960,The Mortal Instruments: City of Bones,2002,60000000,31165421,75965567,15965567,0.27,0
961,The Legend of Bagger Vance,2011,60000000,30695227,39235486,-20764514,-0.35,0
962,Dragonfly,2006,60000000,30063805,30317425,-29682575,-0.49,0
963,Priest,2005,60000000,29136626,84154026,24154026,0.4,0
965,XXX: State of the Union,2003,60000000,26873932,71073932,11073932,0.18,0
966,Event Horizon,2005,60000000,26673242,26673242,-33326758,-0.56,0
968,Dark Water,2006,60000000,25473093,49473093,-10526907,-0.18,0
970,The Black Dahlia,2008,60000000,22672813,49238525,-10761475,-0.18,0
971,EDtv,2001,60000000,22508689,35319689,-24680311,-0.41,0
972,The Spirit,2009,60000000,19806188,39006188,-20993812,-0.35,0
973,The Last Castle,2000,60000000,18208078,20541668,-39458332,-0.66,0
974,Inkheart,2006,60000000,17303424,66655938,6655938,0.11,0
975,Supernova,2014,60000000,14218868,14816494,-45183506,-0.75,0
977,Winterâs Tale,2008,60000000,12600231,29575033,-30424967,-0.51,0
978,Holy Man,2005,60000000,12069719,12069719,-47930281,-0.8,0
979,Meet Dave,2016,60000000,11803254,50648806,-9351194,-0.16,0
980,The Great Raid,2015,60000000,10166502,10597070,-49402930,-0.82,0
981,Rock Dog,2008,60000000,9420546,24148488,-35851512,-0.6,0
982,Mortdecai,2003,60000000,7696134,30396134,-29603866,-0.49,0
983,In the Name of the King: A Dungeon Siege Tale,2016,60000000,4775656,13233220,-46766780,-0.78,0
984,Beyond Borders,2020,60000000,4426297,11427090,-48572910,-0.81,0
985,Xi You Ji zhi Sun Wu Kong San Da Bai Gu Jing,2015,60000000,709982,194058503,134058503,2.23,1
988,Sherlock Gnomes,2016,59000000,43242871,87527651,28527651,0.48,0
989,The Kid Who Would Be King,2014,59000000,16790790,28296983,-30703017,-0.52,0
990,Deadpool,2015,58000000,363070709,785025593,727025593,12.53,1
993,Rambo III,2012,58000000,53715611,188715611,130715611,2.25,1
994,Sabrina,2005,58000000,53458319,87100000,29100000,0.5,0
995,Red Tails,2013,58000000,49876377,50365498,-7634502,-0.13,0
996,Just Like Heaven,2000,58000000,48318130,100687083,42687083,0.74,0
997,The Internship,2008,58000000,44672764,93672764,35672764,0.62,0
998,The Flintstones in Viva Rock Vegas,2017,58000000,35231365,59431365,1431365,0.02,0
999,Leatherheads,2009,58000000,31373938,41348628,-16651372,-0.29,0
1000,Life,2008,58000000,30234022,100929666,42929666,0.74,0
1001,Did You Hear About the Morgans?,2008,58000000,29580087,80480566,22480566,0.39,0
1002,"Che, Part 1: The Argentine",2010,58000000,1802521,31627370,-26372630,-0.45,0
1003,Sex and the City,2012,57500000,152647258,415247258,357747258,6.22,1
1005,That's My Boy,2012,57500000,36931089,58085235,585235,0.01,0
1007,Ghost Rider: Spirit of Vengeance,2004,57000000,51774002,149217355,92217355,1.62,1
1008,Dragonheart,2001,57000000,51364680,104364680,47364680,0.83,0
1009,After the Sunset,2014,57000000,28328132,38329114,-18670886,-0.33,0
1010,Captain Corelli's Mandolin,2003,57000000,25528495,62097495,5097495,0.09,0
1011,Into the Woods,2005,56200000,128002372,213116401,156916401,2.79,1
1012,Anger Management,2004,56000000,135560942,195484552,139484552,2.49,1
1013,The Pacifier,2015,56000000,113006880,198006880,142006880,2.54,1
1014,Walking Tall,2019,56000000,46213824,47856383,-8143617,-0.15,0
1016,Joker,2007,55000000,335451311,1072797850,1017797850,18.51,1
1017,Forrest Gump,2018,55000000,330151138,679838260,624838260,11.36,1
1018,Alvin and the Chipmunks,2005,55000000,217326974,362605033,307605033,5.59,1
1019,Bohemian Rhapsody,2000,55000000,216303339,902038057,847038057,15.4,1
1020,Hitch,2006,55000000,177784257,366784257,311784257,5.67,1
1024,Superman,2017,55000000,134218018,300200000,245200000,4.46,1
1025,The Nutty Professor,2013,55000000,128814019,273814019,218814019,3.98,1
1027,Captain Phillips,2003,55000000,107136417,220648184,165648184,3.01,1
1028,George Of The Jungle,2017,55000000,105263257,174463257,119463257,2.17,1
1029,American Wedding,2014,55000000,104354205,126425115,71425115,1.3,0
1030,Murder on the Orient Express,2018,55000000,102826543,345922730,290922730,5.29,1
1032,Fifty Shades Freed,2010,55000000,100407760,371985018,316985018,5.76,1
1033,Casper,2002,55000000,100328194,282300000,227300000,4.13,1
1035,Maid in Manhattan,2005,55000000,93932896,163838217,108838217,1.98,1
1038,Disclosure,2014,55000000,83015089,212200000,157200000,2.86,1
1039,City of Angels,2006,55000000,78750909,198750909,143750909,2.61,1
1041,R.V.,2003,55000000,71724497,87473024,32473024,0.59,0
1042,Stargate,2011,55000000,71565669,196565669,141565669,2.57,1
1044,Mr. Poppers's Penguins,2004,55000000,68224452,189624452,134624452,2.45,1
1047,Tango &amp; Cash,2000,55000000,63408614,63408614,8408614,0.15,0
1049,Shanghai Noon,2013,55000000,56932305,71189835,16189835,0.29,0
1051,Free Birds,2008,55000000,55750480,110387072,55387072,1.01,0
1052,Alien 3,2004,55000000,54927174,158500000,103500000,1.88,1
1053,The Forbidden Kingdom,2014,55000000,52075270,129075270,74075270,1.35,0
1055,Muppets Most Wanted,2016,55000000,51178893,79312301,24312301,0.44,0
1057,Kubo and the Two Strings,2010,55000000,48023088,77548122,22548122,0.41,0
1059,Burlesque,2008,55000000,39440655,90552675,35552675,0.65,0
1060,The Ghost and the Darkness,2012,55000000,38564422,38564422,-16435578,-0.3,0
1061,Changeling,2003,55000000,35739802,113805580,58805580,1.07,0
1063,The Hunted,2003,55000000,34234008,47213095,-7786905,-0.14,0
1064,Instinct,2008,55000000,34105207,34105207,-20894793,-0.38,0
1065,Stuck On You,2018,55000000,33832741,63537164,8537164,0.16,0
1066,Semi-Pro,2015,55000000,33479698,43980363,-11019637,-0.2,0
1067,Annihilation,2012,55000000,32732301,43070915,-11929085,-0.22,0
1068,Crimson Peak,2005,55000000,31090320,74966854,19966854,0.36,0
1071,Chain Reaction,2007,55000000,21226204,60209334,5209334,0.09,0
1072,The Fan,2009,55000000,18582965,18582965,-36417035,-0.66,0
1073,Elizabeth: The Golden Age,2003,55000000,16285240,74870866,19870866,0.36,0
1075,Gods and Generals,2013,55000000,12882934,12923936,-42076064,-0.77,0
1076,Turbulence,2006,55000000,11532774,11532774,-43467226,-0.79,0
1077,Bullet to the Head,2004,55000000,9489829,22597969,-32402031,-0.59,0
1078,All the King's Men,2004,55000000,7221458,9521458,-45478542,-0.83,0
1079,Thunderbirds,2007,55000000,6768055,28231444,-26768556,-0.49,0
1081,Lucky You,2002,55000000,5755286,6521829,-48478171,-0.88,0
1084,Superman II,2006,54000000,108185706,190400000,136400000,2.53,1
1085,Blade 2,2008,54000000,81676888,154338601,100338601,1.86,1
1087,Seven Pounds,2005,54000000,69951824,166617328,112617328,2.09,1
1088,The Godfather: Part III,2003,54000000,66520529,66520529,12520529,0.23,0
1089,Elizabethtown,2000,54000000,26850426,50719373,-3280627,-0.06,0
1090,Gigli,2005,54000000,6087542,7126002,-46873998,-0.87,0
1091,Shaft,2009,53012938,70327868,107190108,54177170,1.02,0
1092,The Dukes of Hazzard,2015,53000000,80270227,109848461,56848461,1.07,0
1094,Black Mass,2001,53000000,62575678,98837872,45837872,0.86,0
1095,Anastasia,2001,53000000,58403409,139801096,86801096,1.64,1
1096,Moulin Rouge,2006,53000000,57386369,179200588,126200588,2.38,1
1097,Domestic Disturbance,2007,53000000,45207112,54207112,1207112,0.02,0
1099,Grindhouse,2012,53000000,25031037,50187789,-2812211,-0.05,0
1100,Beloved,2002,53000000,22852487,22852487,-30147513,-0.57,0
1101,Zero Dark Thirty,2008,52500000,95720716,134612435,82112435,1.56,1
1102,Catch Me if You Can,2006,52000000,164606800,355612291,303612291,5.84,1
1103,Mamma Mia!,2010,52000000,144130063,615514762,563514762,10.84,1
1105,Valentine's Day,2011,52000000,110485654,217569328,165569328,3.18,1
1108,The Thin Red Line,2010,52000000,36400491,97709034,45709034,0.88,0
1109,Man on the Moon,2003,52000000,34580635,47407635,-4592365,-0.09,0
1110,From Paris With Love,2000,52000000,24077427,53139168,1139168,0.02,0
1111,Bulletproof Monk,2006,52000000,23010607,26922492,-25077508,-0.48,0
1112,"Me, Myself &amp; Irene",2018,51000000,90570999,149270999,98270999,1.93,1
1113,Barnyard: The Original Party Animals,2006,51000000,72779000,118583844,67583844,1.33,0
1114,Alpha,2011,51000000,35851379,99624873,48624873,0.95,0
1115,Deck the Halls,2009,51000000,35093569,46815807,-4184193,-0.08,0
1116,The Adjustment Bureau,2001,50200000,62495645,126931325,76731325,1.53,1
1117,The Twilight Saga: New Moon,2012,50000000,296623634,687557727,637557727,12.75,1
1118,Shrek,2014,50000000,267655011,491812794,441812794,8.84,1
1121,Robin Hood: Prince of Thieves,2015,50000000,165493908,390500000,340500000,6.81,1
1124,As Good as it Gets,2016,50000000,148478011,314111923,264111923,5.28,1
1125,Patch Adams,2013,50000000,135014968,202173000,152173000,3.04,1
1126,Central Intelligence,2011,50000000,127440871,217194805,167194805,3.34,1
1127,Anchorman 2: The Legend Continues,2002,50000000,127413176,172246223,122246223,2.44,1
1128,Super 8,2000,50000000,127004179,257972745,207972745,4.16,1
1129,Mr. Deeds,2018,50000000,126293452,171269535,121269535,2.43,1
1130,Erin Brockovich,2018,50000000,125548685,257805243,207805243,4.16,1
1131,Creed II,2003,50000000,115715889,213591522,163591522,3.27,1
1133,How to Lose a Guy in 10 Days,2018,50000000,105807520,178503788,128503788,2.57,1
1134,Interview with the Vampire: The Vampire Chronicles,2008,50000000,105264608,223564608,173564608,3.47,1
1135,The Mule,2014,50000000,103804407,173671418,123671418,2.47,1
1137,Non-Stop,2013,50000000,91742160,222383055,172383055,3.45,1
1138,Stepmom,2006,50000000,91137662,159745279,109745279,2.19,1
1139,Disney Planes,2006,50000000,90282580,238059569,188059569,3.76,1
1140,Failure to Launch,2017,50000000,88715192,128402901,78402901,1.57,1
1141,Inside Man,2011,50000000,88634237,185798265,135798265,2.72,1
1142,The Emoji Movie,2017,50000000,86089513,216564840,166564840,3.33,1
1145,Payback,2009,50000000,81526121,161626121,111626121,2.23,1
1146,Congo,2005,50000000,81022333,152022333,102022333,2.04,1
1147,Knowing,2011,50000000,79957634,186450317,136450317,2.73,1
1148,The Ring Two,2011,50000000,75941727,161941727,111941727,2.24,1
1149,We Bought a Zoo,2004,50000000,75624550,118729073,68729073,1.37,0
1150,Moneyball,2004,50000000,75605492,111300835,61300835,1.23,0
1151,Garfield: The Movie,2006,50000000,75367693,208094550,158094550,3.16,1
1153,V for Vendetta,2009,50000000,70511035,130214162,80214162,1.6,1
1154,Outbreak,2004,50000000,67823573,190023573,140023573,2.8,1
1155,Race to Witch Mountain,2005,50000000,67172595,105103784,55103784,1.1,0
1156,The Forgotten,2003,50000000,66711892,117211892,67211892,1.34,0
1157,Herbie: Fully Loaded,2014,50000000,66010682,144110682,94110682,1.88,1
1158,Shanghai Knights,2006,50000000,60470220,88316835,38316835,0.77,0
1159,Planes: Fire and Rescue,2012,50000000,59157732,156399644,106399644,2.13,1
1160,Curious George,2013,50000000,58640119,71052604,21052604,0.42,0
1161,American Reunion,2011,50000000,56758835,236799211,186799211,3.74,1
1162,Hansel &amp; Gretel: Witch Hunters,2001,50000000,55703475,214949716,164949716,3.3,1
1163,I am Number Four,2016,50000000,55100437,146195159,96195159,1.92,1
1164,Donât Say a Word,2002,50000000,54997476,104488383,54488383,1.09,0
1165,13 Hours: The Secret Soldiers of Benghazi,2017,50000000,52853219,69411370,19411370,0.39,0
1166,Unfaithful,2005,50000000,52752475,119114494,69114494,1.38,0
1167,American Made,2004,50000000,51342000,135569212,85569212,1.71,1
1168,Syriana,2014,50000000,50824620,92690959,42690959,0.85,0
1170,The Book of Life,2006,50000000,50151543,97651543,47651543,0.95,0
1173,The Game,2014,50000000,48265581,80369970,30369970,0.61,0
1174,G.I. Jane,2014,50000000,48169156,48169156,-1830844,-0.04,0
1175,Into the Storm,2006,50000000,47602194,150429371,100429371,2.01,1
1176,The Judge,2019,50000000,47119388,76073556,26073556,0.52,0
1177,Silent Hill,2000,50000000,46982632,94704227,44704227,0.89,0
1179,The Replacements,2016,50000000,44737059,50054511,54511,0.0,0
1183,Gremlins 2: The New Batch,2003,50000000,41476097,41476097,-8523903,-0.17,0
1184,The Peacemaker,2004,50000000,41263140,62967368,12967368,0.26,0
1185,Out of Time,2000,50000000,41083108,55489826,5489826,0.11,0
1186,Bridget Jones: The Edge Of Reason,2005,50000000,40203020,263894551,213894551,4.28,1
1188,The Adventures of Sharkboy and Lavagirl in 3-D,2009,50000000,39177684,69425966,19425966,0.39,0
1189,On Deadly Ground,2004,50000000,38590458,38590458,-11409542,-0.23,0
1190,Ninja Assassin,2016,50000000,38122883,62209892,12209892,0.24,0
1193,For Love of the Game,2010,50000000,35188640,46112640,-3887360,-0.08,0
1195,Marmaduke,2010,50000000,33644788,89895930,39895930,0.8,0
1196,Striptease,2002,50000000,33109743,113309743,63309743,1.27,0
1198,Murder by Numbers,2017,50000000,31874869,56643267,6643267,0.13,0
1199,Assassins,2016,50000000,30306268,83306268,33306268,0.67,0
1200,Hostiles,2009,50000000,29819114,35481941,-14518059,-0.29,0
1201,Zoolander 2,2007,50000000,28848693,55348693,5348693,0.11,0
1203,Hannibal Rising,2013,50000000,27669725,80583311,30583311,0.61,0
1204,The Story of Us,2003,50000000,27100030,27100030,-22899970,-0.46,0
1205,The Host,2015,50000000,26623701,64477051,14477051,0.29,0
1206,Basic,2002,50000000,26599248,42598498,-7401502,-0.15,0
1207,Run All Night,2009,50000000,26461644,66961644,16961644,0.34,0
1209,The International,2004,50000000,25450527,53850527,3850527,0.08,0
1210,Escape from L.A.,2017,50000000,25426861,25426861,-24573139,-0.49,0
1211,Twisted,2004,50000000,25195050,40119848,-9880152,-0.2,0
1213,The Life Aquatic with Steve Zissou,2019,50000000,24006726,34806726,-15193274,-0.3,0
1214,The Iron Giant,2011,50000000,23159305,31333917,-18666083,-0.37,0
1215,Hellboy,2015,50000000,21903748,40786480,-9213520,-0.18,0
1216,Your Highness,2011,50000000,21596445,26121638,-23878362,-0.48,0
1217,Snowden,2016,50000000,21587519,35380918,-14619082,-0.29,0
1218,Dream House,2009,50000000,21302340,41642166,-8357834,-0.17,0
1219,Free State of Jones,2005,50000000,20810036,23237252,-26762748,-0.54,0
1220,Gamer,2003,50000000,20534907,42002029,-7997971,-0.16,0
1221,Man of the House,2013,50000000,19699706,22099706,-27900294,-0.56,0
1222,The Life of David Gale,2005,50000000,19694635,28920188,-21079812,-0.42,0
1223,Beautiful Creatures,2007,50000000,19452138,60282876,10282876,0.21,0
1227,The Messenger: The Story of Joan of Arc,2011,50000000,14271297,14271297,-35728703,-0.71,0
1230,Mad City,2005,50000000,10561038,10561038,-39438962,-0.79,0
1232,Domino,2009,50000000,10169202,23574057,-26425943,-0.53,0
1233,Jade,2002,50000000,9812870,9812870,-40187130,-0.8,0
1234,Street Fighter: The Legend of Chun-Li,2018,50000000,8742261,12660287,-37339713,-0.75,0
1235,Death to Smoochy,2009,50000000,8355815,8374062,-41625938,-0.83,0
1236,Early Man,2004,50000000,8267544,45285890,-4714110,-0.09,0
1237,The Boat That Rocked,2000,50000000,8017467,37472651,-12527349,-0.25,0
1238,The Big Bounce,2019,50000000,6471394,6626115,-43373885,-0.87,0
1239,What Planet Are You From?,2019,50000000,6291602,6291602,-43708398,-0.87,0
1240,Liu Lang Di Qiu,2020,50000000,5875487,688934822,638934822,12.78,1
1241,Arctic Dogs,2015,50000000,5801249,9648361,-40351639,-0.81,0
1242,The Rhythm Section,2009,50000000,5437971,5983043,-44016957,-0.88,0
1243,Child 44,2012,50000000,1224330,8004221,-41995779,-0.84,0
1245,Upside Down,2019,50000000,102118,26387039,-23612961,-0.47,0
1246,Shanghai,2001,50000000,46425,15505922,-34494078,-0.69,0
1249,The One,2012,49000000,43905746,72689126,23689126,0.48,0
1251,The Adventures of Ford Fairlane,2002,49000000,20423389,20423389,-28576611,-0.58,0
1252,Anna Karenina,2000,49000000,12816367,71004627,22004627,0.45,0
1253,Indiana Jones and the Last Crusade,2002,48000000,197171806,474171806,426171806,8.88,1
1254,The Ring,2015,48000000,129094024,248218486,200218486,4.17,1
1255,Traffic,2019,48000000,124107476,208300000,160300000,3.34,1
1257,Taken 3,2018,48000000,89256424,327656424,279656424,5.83,1
1260,Instant Family,2010,48000000,67363237,119736188,71736188,1.49,0
1261,The Bone Collector,2001,48000000,66488090,151463090,103463090,2.16,1
1262,Three Kings,2007,48000000,60652036,107752036,59752036,1.24,0
1263,Tooth Fairy,2001,48000000,60022256,112610386,64610386,1.35,0
1264,Rat Race,2001,48000000,56607223,86607223,38607223,0.8,0
1265,3:10 to Yuma,2000,48000000,53606916,71171825,23171825,0.48,0
1268,Bedazzled,2019,48000000,37879996,90376224,42376224,0.88,0
1269,Out of Sight,2008,48000000,37562568,77562568,29562568,0.62,0
1270,The Cotton Club,2016,48000000,25928721,25928721,-22071279,-0.46,0
1272,Rambo,2016,47500000,42754105,112214531,64714531,1.36,0
1275,Arrival,2009,47000000,100546139,203127894,156127894,3.32,1
1276,The Cable Guy,2001,47000000,60240295,102825796,55825796,1.19,0
1277,Addams Family Values,2007,47000000,46293855,46293855,-706145,-0.02,0
1278,Earth,2002,47000000,32011576,116773317,69773317,1.48,0
1279,Riding in Cars with Boys,2010,47000000,29781453,29781453,-17218547,-0.37,0
1281,Solaris,2016,47000000,14970038,14970038,-32029962,-0.68,0
1282,Jonah Hex,2012,47000000,10547117,11022696,-35977304,-0.77,0
1284,Silence,2001,46500000,7100177,23726626,-22773374,-0.49,0
1286,My Best Friend's Wedding,2002,46000000,126813153,298923419,252923419,5.5,1
1287,America's Sweethearts,2013,46000000,93607673,160648493,114648493,2.49,1
1290,Prisoners,2015,46000000,61002302,113402302,67402302,1.47,0
1293,Arthur and the War of Two Worlds,2012,45500000,347136,36180824,-9319176,-0.2,0
1295,A Bug's Life,2003,45000000,162798565,363095319,318095319,7.07,1
1296,Taken 2,2000,45000000,139854287,377807404,332807404,7.4,1
1297,The Flintstones,2017,45000000,130531208,358500000,313500000,6.97,1
1298,Scary Movie 3,2008,45000000,110000082,155200000,110200000,2.45,1
1300,Pitch Perfect 3,2004,45000000,104897530,185736412,140736412,3.13,1
1301,Journey to the Center of the Earth,2007,45000000,101704370,243180937,198180937,4.4,1
1303,The Princess Diaries 2: Royal Engagement,2011,45000000,95149435,122071435,77071435,1.71,1
1305,The Client,2005,45000000,92115211,117615211,72615211,1.61,1
1306,The Muppets,2001,45000000,88625922,160971922,115971922,2.58,1
1307,Patriot Games,2016,45000000,83287363,178100000,133100000,2.96,1
1309,Training Day,2001,45000000,76261036,104505362,59505362,1.32,0
1311,Galaxy Quest,2005,45000000,71423726,90523726,45523726,1.01,0
1312,Scary Movie 2,2010,45000000,71277420,141189101,96189101,2.14,1
1313,Blade,2002,45000000,70141876,131237688,86237688,1.92,1
1315,The Bounty Hunter,2006,45000000,67061228,135808837,90808837,2.02,1
1316,Changing Lanes,2019,45000000,66790248,66790248,21790248,0.48,0
1317,Anaconda,2000,45000000,65598907,136998907,91998907,2.04,1
1318,Underworld: Evolution,2003,45000000,62318875,113417762,68417762,1.52,1
1321,Love Actually,2016,45000000,59472278,248282570,203282570,4.52,1
1323,The Specialist,2005,45000000,57362581,170362581,125362581,2.79,1
1324,Office Christmas Party,2005,45000000,54767494,115097874,70097874,1.56,1
1325,Tin Cup,2005,45000000,53854588,75854588,30854588,0.69,0
1326,"Yours, Mine and Ours",2007,45000000,53359917,72359917,27359917,0.61,0
1327,Kicking and Screaming,2004,45000000,52842724,55842724,10842724,0.24,0
1328,The Hitchhiker's Guide to the Galaxy,2012,45000000,51019112,102746214,57746214,1.28,0
1330,Fat Albert,2014,45000000,48114556,48563556,3563556,0.08,0
1331,Savages,2016,45000000,47323100,82513490,37513490,0.83,0
1332,The River Wild,2006,45000000,46815000,94215000,49215000,1.09,0
1333,Blended,2006,45000000,46290741,127990741,82990741,1.84,1
1335,Last Holiday,2004,45000000,38399961,43343247,-1656753,-0.04,0
1336,16 Blocks,2019,45000000,36895141,65595141,20595141,0.46,0
1337,The Indian in the Cupboard,2006,45000000,35627222,35627222,-9372778,-0.21,0
1338,Cellular,2003,45000000,32003620,61475984,16475984,0.37,0
1340,The Ant Bully,2009,45000000,28142535,49610898,4610898,0.1,0
1341,Johnny English,2007,45000000,28013509,161735791,116735791,2.59,1
1342,Dune,2008,45000000,27447471,27447471,-17552529,-0.39,0
1343,Aliens in the Attic,2008,45000000,25200412,59551283,14551283,0.32,0
1344,Across the Universe,2019,45000000,24343673,29367143,-15632857,-0.35,0
1347,Richard Jewell,2019,45000000,22345542,43100570,-1899430,-0.04,0
1349,The Glimmer Man,2001,45000000,20404841,36404841,-8595159,-0.19,0
1350,UglyDolls,2005,45000000,20150241,28162971,-16837029,-0.37,0
1352,The Pledge,2005,45000000,19719930,29406132,-15593868,-0.35,0
1353,The Producers: The Movie Musical,2010,45000000,19398532,32952995,-12047005,-0.27,0
1354,The Phantom,2000,45000000,17220599,17220599,-27779401,-0.62,0
1355,Rebound,2008,45000000,16809014,17492014,-27507986,-0.61,0
1357,All the Pretty Horses,2012,45000000,15527125,18120267,-26879733,-0.6,0
1358,Bangkok Dangerous,2011,45000000,15298133,46598133,1598133,0.04,0
1360,Dredd,2018,45000000,13414714,41467606,-3532394,-0.08,0
1361,The Rum Diary,2011,45000000,13109815,21544732,-23455268,-0.52,0
1362,Deep Rising,2008,45000000,11203026,11203026,-33796974,-0.75,0
1363,Welcome to Marwen,2002,45000000,10763520,13086137,-31913863,-0.71,0
1364,Johnny English Reborn,2006,45000000,8406711,164640401,119640401,2.66,1
1365,Miracle at St. Anna,2007,45000000,7916887,9676497,-35323503,-0.78,0
1366,Big Trouble,2002,45000000,7262288,8488871,-36511129,-0.81,0
1368,Love in the Time of Cholera,2012,45000000,4617608,31077418,-13922582,-0.31,0
1369,Pinocchio,2012,45000000,3681811,31681811,-13318189,-0.3,0
1373,The Fugitive,2010,44000000,183875760,353715317,309715317,7.04,1
1375,Sleepers,2014,44000000,53300852,165600852,121600852,2.76,1
1377,The Juror,2013,44000000,22730924,22730924,-21269076,-0.48,0
1378,The Interview,2000,44000000,6105175,12342632,-31657368,-0.72,0
1380,The Heat,2005,43000000,159581587,229727774,186727774,4.34,1
1381,Finding Forrester,2002,43000000,51768623,80013623,37013623,0.86,0
1382,28 Days,2018,43000000,37035515,62063972,19063972,0.44,0
1383,Danny the Dog,2016,43000000,24537621,49037621,6037621,0.14,0
1384,The Sweetest Thing,2011,43000000,24430272,63078756,20078756,0.47,0
1386,A Monster Calls,2012,43000000,3740823,46414530,3414530,0.08,0
1388,The Firm,2019,42000000,158340892,270340892,228340892,5.44,1
1389,21 Jump Street,2000,42000000,138447667,202812429,160812429,3.83,1
1390,Notting Hill,2004,42000000,116089678,363718196,321718196,7.66,1
1392,Chicken Run,2009,42000000,106793915,227793915,185793915,4.42,1
1394,Boomerang,2017,42000000,70052444,131052444,89052444,2.12,1
1395,BrÃ¼no,2012,42000000,60054530,138708527,96708527,2.3,1
1396,Cleopatra,2002,42000000,57000000,71000000,29000000,0.69,0
1398,Here Comes the Boom,2011,42000000,45290318,73239258,31239258,0.74,0
1399,High Crimes,2002,42000000,41543207,63781100,21781100,0.52,0
1401,Red Riding Hood,2018,42000000,37662162,91678442,49678442,1.18,0
1402,The Mothman Prophecies,2012,42000000,35228696,56438555,14438555,0.34,0
1403,Licence to Kill,2001,42000000,34667015,156167015,114167015,2.72,1
1404,Holmes &amp; Watson,2005,42000000,30568743,41926605,-73395,-0.0,0
1407,Lord of War,2012,42000000,24149632,60437727,18437727,0.44,0
1408,Super Mario Bros.,2010,42000000,20844907,20844907,-21155093,-0.5,0
1410,Man on a Ledge,2010,42000000,18620000,49621440,7621440,0.18,0
1411,The Warrior's Way,2015,42000000,5666340,8514325,-33485675,-0.8,0
1413,Micmacs,2019,42000000,1259693,18821576,-23178424,-0.55,0
1415,Pourquoi j'ai pas mangÃ© mon pÃ¨re,2003,42000000,0,15451663,-26548337,-0.63,0
1416,8 Mile,2011,41000000,116724075,245768384,204768384,4.99,1
1418,A Knightâs Tale,2005,41000000,56083966,100622586,59622586,1.45,0
1419,The Medallion,2010,41000000,22108977,22108977,-18891023,-0.46,0
1420,The Big Year,2019,41000000,7204138,7684524,-33315476,-0.81,0
1421,The Sixth Sense,2015,40000000,293506292,672806292,632806292,15.82,1
1422,Wedding Crashers,2019,40000000,209218368,283218368,243218368,6.08,1
1423,The Karate Kid,2009,40000000,176591618,351774938,311774938,7.79,1
1424,John Wick: Chapter 3 â Parabellum,2013,40000000,171015687,325785782,285785782,7.14,1
1425,Fifty Shades of Grey,2003,40000000,166167230,570998101,530998101,13.27,1
1426,Knives Out,2014,40000000,165363254,307288780,267288780,6.68,1
1427,The Proposal,2013,40000000,163958031,314709717,274709717,6.87,1
1430,Lucy,2003,40000000,126573960,457507776,417507776,10.44,1
1433,Double Jeopardy,2016,40000000,116735231,177835231,137835231,3.45,1
1434,Spy Kids 3-D: Game Over,2010,40000000,111760631,167851995,127851995,3.2,1
1435,A Time to Kill,2009,40000000,108766007,152266007,112266007,2.81,1
1436,A League of Their Own,2009,40000000,107533925,132440066,92440066,2.31,1
1437,The Conjuring 2: The Enfield Poltergeist,2017,40000000,102470008,310475892,270475892,6.76,1
1438,The Social Network,2016,40000000,96962694,224922135,184922135,4.62,1
1439,Julie &amp; Julia,2006,40000000,94125426,131516178,91516178,2.29,1
1440,He's Just Not That Into You,2015,40000000,93953653,181053657,141053657,3.53,1
1441,John Wick: Chapter Two,2000,40000000,92029184,171317271,131317271,3.28,1
1443,Scary Movie 4,2016,40000000,90710620,178710620,138710620,3.47,1
1444,Get Hard,2014,40000000,90411453,106511453,66511453,1.66,1
1445,Scream 3,2014,40000000,89138076,161838076,121838076,3.05,1
1447,The Accountant,2006,40000000,86260045,152962083,112962083,2.82,1
1449,The Other Woman,2015,40000000,83911193,195111193,155111193,3.88,1
1451,Eight Below,2004,40000000,81612565,120455994,80455994,2.01,1
1452,The Talented Mr. Ripley,2005,40000000,81292135,128792135,88792135,2.22,1
1453,The Intern,2015,40000000,75764672,197115710,157115710,3.93,1
1454,The Last of the Mohicans,2008,40000000,75505856,75505856,35505856,0.89,0
1455,Ray,2009,40000000,75305995,124823094,84823094,2.12,1
1456,Sin City,2001,40000000,74103820,158527918,118527918,2.96,1
1458,Vantage Point,2006,40000000,72266306,150886329,110886329,2.77,1
1459,"I Love You, Man",2019,40000000,72013010,92302502,52302502,1.31,0
1460,Shallow Hal,2018,40000000,70836296,70836296,30836296,0.77,0
1461,JFK,2016,40000000,70405498,205400000,165400000,4.14,1
1462,Big Momma's House 2,2001,40000000,70165972,137047376,97047376,2.43,1
1463,Angel Has Fallen,2009,40000000,69030436,133365452,93365452,2.33,1
1464,The House with a Clock in its Walls,2009,40000000,68549695,131457147,91457147,2.29,1
1465,Hacksaw Ridge,2011,40000000,67209615,168904682,128904682,3.22,1
1466,The Mexican,2010,40000000,66808615,145238250,105238250,2.63,1
1467,The Final Destination,2003,40000000,66477700,187384627,147384627,3.68,1
1468,17 Again,2001,40000000,64167069,139474906,99474906,2.49,1
1469,Unknown,2011,40000000,63686397,136123083,96123083,2.4,1
1470,Get Him to the Greek,2004,40000000,61153526,92994927,52994927,1.32,0
1471,Gothika,2006,40000000,59588068,141484812,101484812,2.54,1
1472,Behind Enemy Lines,2013,40000000,58855732,58855732,18855732,0.47,0
1475,Invincible,2014,40000000,57806952,58501127,18501127,0.46,0
1476,Escape From Planet Earth,2002,40000000,57012977,74156610,34156610,0.85,0
1477,Small Soldiers,2006,40000000,55143823,71743823,31743823,0.79,0
1478,Spawn,2006,40000000,54979992,87949859,47949859,1.2,0
1479,Horrible Bosses 2,2010,40000000,54445357,105945357,65945357,1.65,1
1480,The Count of Monte Cristo,2012,40000000,54228104,75389090,35389090,0.88,0
1482,The Lake House,2006,40000000,52330111,114830111,74830111,1.87,1
1483,Predators,2007,40000000,52000688,127234389,87234389,2.18,1
1485,The Living Daylights,2004,40000000,51185000,191200000,151200000,3.78,1
1486,Apocalypto,2005,40000000,50866635,121032272,81032272,2.03,1
1487,Music and Lyrics,2014,40000000,50572589,146196885,106196885,2.65,1
1488,Legal Eagles,2008,40000000,49851591,49851591,9851591,0.25,0
1492,Made of Honor,2014,40000000,46012734,106548738,66548738,1.66,1
1493,The Rainmaker,2011,40000000,45916769,45916769,5916769,0.15,0
1494,Medicine Man,2018,40000000,44948240,44948240,4948240,0.12,0
1495,Amistad,2005,40000000,44212592,58250151,18250151,0.46,0
1496,A Million Ways to Die in The West,2007,40000000,42720965,86778557,46778557,1.17,0
1497,Final Destination 5,2007,40000000,42587643,155011165,115011165,2.88,1
1498,Widows,2014,40000000,42402632,73866088,33866088,0.85,0
1499,Fever Pitch,2011,40000000,42071069,50071069,10071069,0.25,0
1501,The Water Horse: Legend of the Deep,2000,40000000,40412817,103429755,63429755,1.59,1
1502,Sex Tape,2011,40000000,38543473,126069509,86069509,2.15,1
1503,Scream 4,2012,40000000,38180928,95989590,55989590,1.4,0
1504,Ri¢hie Ri¢h,2011,40000000,38087756,38087756,-1912244,-0.05,0
1506,Paul,2018,40000000,37412945,101162106,61162106,1.53,1
1507,The Guilt Trip,2000,40000000,37134215,41294674,1294674,0.03,0
1510,The Commuter,2018,40000000,36343858,118509836,78509836,1.96,1
1511,Hanging Up,2000,40000000,36037909,51867723,11867723,0.3,0
1512,The Doors,2011,40000000,34416893,34420595,-5579405,-0.14,0
1513,Mickey Blue Eyes,2008,40000000,33864342,53864342,13864342,0.35,0
1514,The Spy Who Dumped Me,2016,40000000,33562069,77109957,37109957,0.93,0
1515,Pay it Forward,2011,40000000,33508922,55696705,15696705,0.39,0
1517,Drillbit Taylor,2008,40000000,32862104,49686263,9686263,0.24,0
1518,Patriots Day,2010,40000000,31886361,52837989,12837989,0.32,0
1519,Extremely Loud and Incredibly Close,2005,40000000,31847881,55247881,15247881,0.38,0
1520,The Shadow,2019,40000000,31835600,31835600,-8164400,-0.2,0
1521,Transporter 3,2000,40000000,31715062,112930957,72930957,1.82,1
1522,Morning Glory,2013,40000000,31011732,59795070,19795070,0.49,0
1523,Get Rich or Die Tryin',2000,40000000,30981850,46666955,6666955,0.17,0
1524,Long Shot,2005,40000000,30316271,53624424,13624424,0.34,0
1526,Grudge Match,2017,40000000,29817991,69817991,29817991,0.75,0
1528,Rent,2001,40000000,29077547,31670620,-8329380,-0.21,0
1529,The Out-of-Towners,2016,40000000,28544120,28544120,-11455880,-0.29,0
1530,The Nut Job 2: Nutty by Nature,2008,40000000,28370522,57438389,17438389,0.44,0
1531,The Island of Dr. Moreau,2017,40000000,27682712,27682712,-12317288,-0.31,0
1532,The Musketeer,2001,40000000,27053815,27053815,-12946185,-0.32,0
1533,Resident Evil: The Final Chapter,2007,40000000,26844692,314101190,274101190,6.85,1
1534,The Other Boleyn Girl,2011,40000000,26814957,78269970,38269970,0.96,0
1537,The Reaping,2002,40000000,25126214,62226214,22226214,0.56,0
1539,Renaissance Man,2016,40000000,24172899,24172899,-15827101,-0.4,0
1540,Quest for Camelot,2004,40000000,22772500,38172500,-1827500,-0.05,0
1541,City by the Sea,2009,40000000,22433915,22505932,-17494068,-0.44,0
1542,At First Sight,2018,40000000,22365133,22365133,-17634867,-0.44,0
1545,Fantastic Mr. Fox,2012,40000000,21002919,47083412,7083412,0.18,0
1546,The Happytime Murders,2012,40000000,20706452,27506412,-12493588,-0.31,0
1547,Showgirls,2012,40000000,20350754,37750754,-2249246,-0.06,0
1548,City Hall,2017,40000000,20278055,20278055,-19721945,-0.49,0
1549,Big Miracle,2006,40000000,20157300,25268680,-14731320,-0.37,0
1550,The Impossible,2018,40000000,19019882,169590606,129590606,3.24,1
1551,A Thousand Words,2000,40000000,18450127,20790486,-19209514,-0.48,0
1553,Marie Antoinette,2016,40000000,15962471,60862471,20862471,0.52,0
1554,Hunter Killer,2002,40000000,15767460,29325209,-10674791,-0.27,0
1557,Keeping Up with the Joneses,2009,40000000,14904426,28804426,-11195574,-0.28,0
1558,"Life, or Something Like It",2009,40000000,14448589,14448589,-25551411,-0.64,0
1559,Ishtar,2004,40000000,14375181,14375181,-25624819,-0.64,0
1561,Amelia,2004,40000000,14279575,19756077,-20243923,-0.51,0
1562,Cirque du Freak: The Vampire's Assistant,2002,40000000,14046595,39753957,-246043,-0.01,0
1563,New York Minute,2008,40000000,14018364,21156715,-18843285,-0.47,0
1564,The Deep End of the Ocean,2015,40000000,13508635,13508635,-26491365,-0.66,0
1566,FearDotCom,2009,40000000,13208023,13289290,-26710710,-0.67,0
1567,Soul Men,2003,40000000,12082391,12345883,-27654117,-0.69,0
1568,The Gunman,2013,40000000,10664749,18594227,-21405773,-0.54,0
1570,Pandorum,2015,40000000,10330853,17033431,-22966569,-0.57,0
1571,Duplex,2018,40000000,9652000,10070651,-29929349,-0.75,0
1572,Paranoia,2002,40000000,7388654,16340767,-23659233,-0.59,0
1573,Raise the Titanic,2015,40000000,7000000,7000000,-33000000,-0.82,0
1574,Baahubali: The Beginning,2019,40000000,6738000,26736665,-13263335,-0.33,0
1575,The Hurricane Heist,2002,40000000,6115824,30963684,-9036316,-0.23,0
1576,Impostor,2001,40000000,6114237,7974607,-32025393,-0.8,0
1577,Victor Frankenstein,2013,40000000,5775076,31124367,-8875633,-0.22,0
1578,The Goldfinch,2007,40000000,5332621,9430149,-30569851,-0.76,0
1580,Just Visiting,2016,40000000,4777007,16172200,-23827800,-0.6,0
1582,Sunshine,2008,40000000,3688560,32030610,-7969390,-0.2,0
1583,The Hudsucker Proxy,2007,40000000,2816518,14938149,-25061851,-0.63,0
1584,Billy Lynnâs Long Halftime Walk,2006,40000000,1738477,30230402,-9769598,-0.24,0
1585,Pirates,2009,40000000,1641825,6341825,-33658175,-0.84,0
1587,The Hunting Party,2007,40000000,876671,7729552,-32270448,-0.81,0
1588,Alex Rider: Operation Stormbreaker,2013,40000000,659210,20722450,-19277550,-0.48,0
1589,Red Cliff,2012,40000000,627047,119627047,79627047,1.99,1
1592,Un monstre Ã  Paris ,2015,40000000,0,27000381,-12999619,-0.32,0
1593,Solomon Kane,2017,40000000,0,22024849,-17975151,-0.45,0
1594,Kursk,2020,40000000,0,5578259,-34421741,-0.86,0
1601,The Time Traveler's Wife,2005,39000000,63414846,102332135,63332135,1.62,1
1602,Superman III,2007,39000000,59950623,80200000,41200000,1.06,0
1603,Because I Said So,2004,39000000,42674040,69538833,30538833,0.78,0
1604,Frankenweenie,2013,39000000,35287788,81150788,42150788,1.08,0
1605,Sgt. Bilko,2001,39000000,30356589,37956589,-1043411,-0.03,0
1606,Serenity,2002,39000000,25514517,40319440,1319440,0.03,0
1607,Shoot 'Em Up,2009,39000000,12796824,26796824,-12203176,-0.31,0
1608,Against the Ropes,2002,39000000,5881504,6429865,-32570135,-0.84,0
1610,The Fast and the Furious,2017,38000000,144512310,206458372,168458372,4.43,1
1611,Sweet Home Alabama,2015,38000000,127214072,182365114,144365114,3.8,1
1613,Spy Kids 2: The Island of Lost Dreams,2016,38000000,85846296,119721296,81721296,2.15,1
1614,Star Trek: Generations,2011,38000000,75671262,120000000,82000000,2.16,1
1615,Captain Underpants: The First Epic Movie,2010,38000000,73921000,126577874,88577874,2.33,1
1617,Mouse Hunt,2013,38000000,61894591,61894591,23894591,0.63,0
1618,Why Him?,2001,38000000,60323786,117425156,79425156,2.09,1
1619,Water for Elephants,2002,38000000,58709717,116809717,78809717,2.07,1
1620,Life as We Know It,2016,38000000,53374681,105887837,67887837,1.79,1
1621,The Hurricane,2009,38000000,50699241,73956241,35956241,0.95,0
1622,Riddick,2013,38000000,42025135,94763758,56763758,1.49,0
1623,Heartbreakers,2001,38000000,40334024,57753825,19753825,0.52,0
1624,Enough,2001,38000000,39177215,50970660,12970660,0.34,0
1625,The 5th Wave,2018,38000000,34912982,111336398,73336398,1.93,1
1626,Push,2000,38000000,31811527,49678401,11678401,0.31,0
1627,Rush,2017,38000000,26947624,98230839,60230839,1.59,1
1629,Joe Somebody,2011,38000000,22770864,24515990,-13484010,-0.35,0
1630,Overlord,2001,38000000,21704844,39178189,1178189,0.03,0
1631,The Ninth Gate,2019,38000000,18653746,58394308,20394308,0.54,0
1633,Extreme Measures,2008,38000000,17378193,17378193,-20621807,-0.54,0
1635,Rock Star,2018,38000000,16991902,19317765,-18682235,-0.49,0
1636,The Kitchen,2001,38000000,12180032,15779653,-22220347,-0.58,0
1637,White Squall,2008,38000000,10229300,10229300,-27770700,-0.73,0
1638,City of Ember,2019,38000000,7873007,17831558,-20168442,-0.53,0
1639,Switchback,2012,38000000,6504442,6504442,-31495558,-0.83,0
1640,The Sisters Brothers,2012,38000000,3143056,13119947,-24880053,-0.65,0
1643,The Upside,2013,37500000,108235497,125818440,88318440,2.36,1
1644,What to Expect When You're Expecting,2015,37500000,41152203,88473016,50973016,1.36,0
1645,The Master,2010,37500000,16247159,50879131,13379131,0.36,0
1646,The Express,2011,37500000,9793406,9813309,-27686691,-0.74,0
1647,Twilight,2018,37000000,192769854,402280159,365280159,9.87,1
1648,We're the Millers,2008,37000000,150394119,267816276,230816276,6.24,1
1649,Creed,2004,37000000,109767581,173567581,136567581,3.69,1
1650,The Town,2013,37000000,92186262,152566881,115566881,3.12,1
1651,Dolphin Tale,2008,37000000,72286779,96068724,59068724,1.6,1
1652,Game Night,2016,37000000,69179066,117378084,80378084,2.17,1
1653,Burn After Reading,2010,37000000,60355347,168167798,131167798,3.55,1
1654,13 Going On 30,2011,37000000,57139723,97658712,60658712,1.64,1
1655,Tyler Perryâs Temptation,2008,37000000,51975354,53143144,16143144,0.44,0
1657,How to be Single,2015,37000000,46843513,100003780,63003780,1.7,1
1658,Cop Out,2018,37000000,44875481,55909910,18909910,0.51,0
1659,The Rite,2011,37000000,33047633,97143987,60143987,1.63,1
1660,Space Chimps,2002,37000000,30105968,67029956,30029956,0.81,0
1665,Gnomeo and Juliet,2014,36000000,99967670,193737977,157737977,4.38,1
1666,John Q,2016,36000000,71026631,102226631,66226631,1.84,1
1667,Blue Streak,2003,36000000,68208190,117448157,81448157,2.26,1
1668,Never Say Never Again,2000,36000000,55500000,160000000,124000000,3.44,1
1672,Collateral Beauty,2000,36000000,31016021,85309093,49309093,1.37,0
1673,A Man Apart,2015,36000000,26500000,43797731,7797731,0.22,0
1674,Reindeer Games,2011,36000000,23360779,23360779,-12639221,-0.35,0
1675,Snow Falling on Cedars,2015,36000000,14378353,14378353,-21621647,-0.6,0
1676,Ghosts of Mississippi,2003,36000000,13052741,13052741,-22947259,-0.64,0
1677,Gattaca,2017,36000000,12532777,12532777,-23467223,-0.65,0
1679,Yip Man 3,2009,36000000,2679437,157300954,121300954,3.37,1
1682,Head of State,2010,35200000,37788228,38283765,3083765,0.09,0
1685,The Blind Side,2013,35000000,255959475,305705794,270705794,7.73,1
1686,Batman,2006,35000000,251188924,411348924,376348924,10.75,1
1687,Austin Powers: The Spy Who Shagged Me,2011,35000000,206040085,312383487,277383487,7.93,1
1688,True Grit,2001,35000000,171243005,252276928,217276928,6.21,1
1689,Lethal Weapon 3,2015,35000000,144731527,319700000,284700000,8.13,1
1690,Rush Hour,2013,35000000,141186864,245300000,210300000,6.01,1
1692,The Devil Wears Prada,2008,35000000,124740460,326073155,291073155,8.32,1
1693,Horrible Bosses,2008,35000000,117538559,212417601,177417601,5.07,1
1696,Saving Mr. Banks,2009,35000000,83299761,114962525,79962525,2.28,1
1697,Star Trek: The Motion Picture,2005,35000000,82258456,139000000,104000000,2.97,1
1698,21,2012,35000000,81159365,159846429,124846429,3.57,1
1700,Cape Fear,2005,35000000,79091969,182291969,147291969,4.21,1
1702,Hotel for Dogs,2010,35000000,73178547,122357172,87357172,2.5,1
1703,Guess Who,2000,35000000,68915888,102115888,67115888,1.92,1
1705,L.A. Confidential,2006,35000000,64604977,126204977,91204977,2.61,1
1706,Sky High,2010,35000000,63939454,83109359,48109359,1.37,0
1708,A Nightmare on Elm Street,2011,35000000,63075011,117729621,82729621,2.36,1
1709,The Cell,2016,35000000,61280963,85911226,50911226,1.45,0
1710,Species,2007,35000000,60054449,113354449,78354449,2.24,1
1711,The Benchwarmers,2003,35000000,59843754,65063726,30063726,0.86,0
1712,Secretariat,2018,35000000,59699513,60376247,25376247,0.73,0
1713,The Man in the Iron Mask,2009,35000000,56968169,56968169,21968169,0.63,0
1715,Neighbors 2: Sorority Rising,2015,35000000,55340730,108757621,73757621,2.11,1
1716,TMNT,2018,35000000,54149098,96096018,61096018,1.75,1
1717,Radio,2018,35000000,52333738,53293628,18293628,0.52,0
1718,Sicario: Day of the Soldado,2009,35000000,50065850,75885196,40885196,1.17,0
1719,Old Dogs,2005,35000000,49492060,95104304,60104304,1.72,1
1720,Malcolm X,2007,35000000,48169910,48169910,13169910,0.38,0
1722,Goosebumps 2: Haunted Halloween,2008,35000000,46697321,93291478,58291478,1.67,1
1723,12 Strong,2002,35000000,45819713,71118378,36118378,1.03,0
1724,Underworld 3: Rise of the Lycans,2004,35000000,45802315,89102315,54102315,1.55,1
1725,Must Love Dogs,2011,35000000,43894863,58405313,23405313,0.67,0
1726,License to Wed,2006,35000000,43799818,70187088,35187088,1.01,0
1727,Donnie Brasco,2011,35000000,41954997,65303052,30303052,0.87,0
1728,Max Payne,2010,35000000,40689393,87775050,52775050,1.51,1
1729,Resident Evil,2011,35000000,40119709,103787401,68787401,1.97,1
1730,The Ladykillers,2000,35000000,39692139,77392139,42392139,1.21,0
1731,Something Borrowed,2018,35000000,39046489,65084116,30084116,0.86,0
1732,The Nativity Story,2015,35000000,37629831,46309644,11309644,0.32,0
1733,In Time,2015,35000000,37553932,165103952,130103952,3.72,1
1734,The Back-up Plan,2017,35000000,37490007,75281179,40281179,1.15,0
1735,J. Edgar,2004,35000000,37306030,84606030,49606030,1.42,0
1737,Mile 22,2001,35000000,36108758,66295121,31295121,0.89,0
1738,Hot Pursuit,2005,35000000,34580201,45671512,10671512,0.3,0
1739,Concussion,2002,35000000,34531832,50363790,15363790,0.44,0
1740,The Foreigner,2005,35000000,34393507,140783360,105783360,3.02,1
1741,Closer,2001,35000000,33987757,116177695,81177695,2.32,1
1742,Street Fighter,2018,35000000,33423000,99423000,64423000,1.84,1
1743,Black Knight,2008,35000000,33422806,33422806,-1577194,-0.05,0
1744,The Bad News Bears,2016,35000000,32868349,33500620,-1499380,-0.04,0
1745,The Pianist,2002,35000000,32519322,111854182,76854182,2.2,1
1746,House of Wax,2010,35000000,32064800,70064800,35064800,1.0,0
1747,From Hell,2008,35000000,31598308,68712365,33712365,0.96,0
1749,Mirrors,2011,35000000,30691439,77220596,42220596,1.21,0
1751,Queen of the Damned,2008,35000000,30307804,30307804,-4692196,-0.13,0
1753,Untraceable,2012,35000000,28687835,52649951,17649951,0.5,0
1754,Predator 2,2004,35000000,28317513,54768418,19768418,0.56,0
1756,Flash Gordon,2016,35000000,27107960,27107960,-7892040,-0.23,0
1757,Superhero Movie,2001,35000000,26638520,73026302,38026302,1.09,0
1759,Alex Cross,2016,35000000,25888412,35426759,426759,0.01,0
1760,Jersey Girl,2004,35000000,25266129,37066129,2066129,0.06,0
1761,Midnight in the Garden of Good and Evil,2015,35000000,25078937,25078937,-9921063,-0.28,0
1762,Bridget Jonesâs Baby,2017,35000000,24139805,205822688,170822688,4.88,1
1763,Heist,2008,35000000,23483357,28906817,-6093183,-0.17,0
1764,Hoffa,2012,35000000,23365858,28391473,-6608527,-0.19,0
1765,Whiskey Tango Foxtrot,2013,35000000,23083334,25350747,-9649253,-0.28,0
1766,Ella Enchanted,2005,35000000,22913677,22913677,-12086323,-0.35,0
1767,Hitman: Agent 47,2000,35000000,22467450,82182803,47182803,1.35,0
1768,Phantom Thread,2005,35000000,21198205,47896721,12896721,0.37,0
1769,The X-Files: I Want to Believe,2007,35000000,20982478,68170792,33170792,0.95,0
1770,Premium Rush,2002,35000000,20275446,31393201,-3606799,-0.1,0
1771,Broken City,2010,35000000,19701164,34480045,-519955,-0.01,0
1772,Valiant,2013,35000000,19478106,64188387,29188387,0.83,0
1773,Wonder Boys,2004,35000000,19389454,33422485,-1577515,-0.05,0
1774,Cursed,2000,35000000,19294901,25114901,-9885099,-0.28,0
1775,Walk Hard: The Dewey Cox Story,2000,35000000,18317151,20606053,-14393947,-0.41,0
1776,The Four Feathers,2007,35000000,18306166,29882645,-5117355,-0.15,0
1778,Parker,2011,35000000,17616641,48543388,13543388,0.39,0
1779,Wimbledon,2001,35000000,16862585,41666476,6666476,0.19,0
1780,Bait,2012,35000000,15325127,15471969,-19528031,-0.56,0
1781,Dungeons and Dragons,2006,35000000,15185241,33771965,-1228035,-0.04,0
1782,Lions for Lambs,2001,35000000,14998070,63211088,28211088,0.81,0
1783,Flight of the Intruder,2009,35000000,14471440,14471440,-20528560,-0.59,0
1784,The Tree of Life,2014,35000000,13305665,61721826,26721826,0.76,0
1786,Playing for Keeps,2009,35000000,13103272,27805632,-7194368,-0.21,0
1787,Zoom,2015,35000000,11989328,12506188,-22493812,-0.64,0
1788,The Shipping News,2015,35000000,11405825,24405825,-10594175,-0.3,0
1789,The Young Victoria,2006,35000000,11001272,31878891,-3121109,-0.09,0
1790,Sabotage,2013,35000000,10508518,18376443,-16623557,-0.47,0
1791,Knock Off,2008,35000000,10319915,10319915,-24680085,-0.71,0
1792,Whiteout,2003,35000000,10275638,12254746,-22745254,-0.65,0
1793,Unfinished Business,2006,35000000,10219501,13214051,-21785949,-0.62,0
1794,The Walk,2016,35000000,10161183,61492104,26492104,0.76,0
1795,The Fountain,2017,35000000,10144010,15461638,-19538362,-0.56,0
1796,Mandela: Long Walk to Freedom,2002,35000000,8323085,29890402,-5109598,-0.15,0
1798,The Order,2003,35000000,7659747,11559747,-23440253,-0.67,0
1799,A Good Year,2011,35000000,7459300,42064105,7064105,0.2,0
1802,Femme Fatale,2016,35000000,6630252,16830252,-18169748,-0.52,0
1808,A Hologram for the King,2012,35000000,4212494,11846010,-23153990,-0.66,0
1814,Stolen,2014,35000000,289773,17967746,-17032254,-0.49,0
1821,The Maze Runner,2000,34000000,102427862,348319861,314319861,9.24,1
1822,The Longest Ride,2014,34000000,37446117,63802928,29802928,0.88,0
1825,The Darkest Minds,2000,34000000,12695691,38361428,4361428,0.13,0
1826,Chill Factor,2001,34000000,11263966,11263966,-22736034,-0.67,0
1827,The Astronaut's Wife,2016,34000000,10672566,10672566,-23327434,-0.69,0
1828,I Dreamed of Africa,2012,34000000,6543194,14291999,-19708001,-0.58,0
1829,Thunder and the House of Magic,2006,34000000,4091,62582520,28582520,0.84,0
1830,Reds,2004,33500000,50000000,50000000,16500000,0.49,0
1831,A Few Good Men,2000,33000000,141340178,236500000,203500000,6.17,1
1832,Big Momma's House,2019,33000000,117559438,173559438,140559438,4.26,1
1833,Exit Wounds,2012,33000000,51758599,79958599,46958599,1.42,0
1834,Mike and Dave Need Wedding Dates,2008,33000000,46009673,75898100,42898100,1.3,0
1836,Snakes on a Plane,2006,33000000,34020814,62020814,29020814,0.88,0
1837,The Punisher,2015,33000000,33664370,54533774,21533774,0.65,0
1838,The Watcher,2015,33000000,28946615,47267829,14267829,0.43,0
1839,21 Bridges,2020,33000000,28539757,40013645,7013645,0.21,0
1841,Doomsday,2011,33000000,11008770,21621188,-11378812,-0.34,0
1842,Pushing Tin,2008,33000000,8408835,8408835,-24591165,-0.75,0
1843,Goal! The Dream Begins,2013,33000000,4283255,27610873,-5389127,-0.16,0
1847,Star Wars Ep. VI: Return of the Jedi,2013,32500000,309205079,475106177,442606177,13.62,1
1848,Bridesmaids,2002,32500000,169211718,289632023,257132023,7.91,1
1849,The Reader,2006,32500000,34194407,112964875,80464875,2.48,1
1851,Wanderlust,2010,32500000,17288155,24159934,-8340066,-0.26,0
1852,Elf,2011,32000000,174626840,221464732,189464732,5.92,1
1854,This is the End,2000,32000000,101470202,126539117,94539117,2.95,1
1855,Snow Dogs,2018,32000000,81150692,116898028,84898028,2.65,1
1856,Nacho Libre,2005,32000000,80197993,99296462,67296462,2.1,1
1857,Scrooged,2011,32000000,59450353,59450353,27450353,0.86,0
1859,Source Code,2007,32000000,54712227,140428499,108428499,3.39,1
1861,Men of Honor,2005,32000000,48814909,82339483,50339483,1.57,1
1862,I Feel Pretty,2019,32000000,48795601,91444095,59444095,1.86,1
1863,The Transporter 2,2005,32000000,43095856,88978458,56978458,1.78,1
1864,"Big Mommas: Like Father, Like Son",2013,32000000,37915414,82332450,50332450,1.57,1
1866,The Number 23,2004,32000000,35193167,77593167,45593167,1.42,0
1867,1941,2018,32000000,34175000,94875000,62875000,1.96,1
1868,Dreamer: Inspired by a True Story,2010,32000000,33022286,39498360,7498360,0.23,0
1870,A History of Violence,2010,32000000,31493782,61477797,29477797,0.92,0
1871,The Incredible Burt Wonderstone,2007,32000000,22537881,27392609,-4607391,-0.14,0
1875,Going the Distance,2006,32000000,17804299,43603990,11603990,0.36,0
1877,Repo Men,2015,32000000,13942007,18195238,-13804762,-0.43,0
1878,Dragon Wars: D-War,2018,32000000,10977721,79915361,47915361,1.5,1
1884,Apocalypse Now,2014,31500000,83471511,85915846,54415846,1.73,1
1885,Criminal,2015,31500000,14708696,38771262,7271262,0.23,0
1887,42,2019,31000000,95020213,97470701,66470701,2.14,1
1888,Flight,2000,31000000,93772375,160558438,129558438,4.18,1
1889,Mr. Hollandâs Opus,2001,31000000,82582604,106282604,75282604,2.43,1
1890,Out of Africa,2010,31000000,79096868,258210860,227210860,7.33,1
1891,Moonraker,2017,31000000,70300000,210300000,179300000,5.78,1
1895,Isnât it Romantic,2018,31000000,48791187,48791187,17791187,0.57,0
1896,Frequency,2002,31000000,44983704,68079671,37079671,1.2,0
1898,Extraordinary Measures,2001,31000000,12482741,15826984,-15173016,-0.49,0
1899,Birth of the Dragon,2012,31000000,6901965,7220490,-23779510,-0.77,0
1902,Toy Story,2013,30000000,191796233,364543951,334543951,11.15,1
1903,Crazy Rich Asians,2000,30000000,174532921,238099711,208099711,6.94,1
1904,Chicago,2009,30000000,170687518,306770545,276770545,9.23,1
1905,Big Daddy,2004,30000000,163479795,228641283,198641283,6.62,1
1908,Speed,2001,30000000,121248145,283200000,253200000,8.44,1
1911,Remember the Titans,2004,30000000,115654751,136706683,106706683,3.56,1
1913,Dodgeball: A True Underdog Story,2003,30000000,114326736,167791704,137791704,4.59,1
1914,The Addams Family,2015,30000000,113502246,191502246,161502246,5.38,1
1916,The Princess Diaries,2004,30000000,108244774,165334774,135334774,4.51,1
1917,Analyze This,2009,30000000,106885658,176885658,146885658,4.9,1
1918,The First Wives Club,2004,30000000,105489203,181489203,151489203,5.05,1
1919,Million Dollar Baby,2009,30000000,100492203,231928227,201928227,6.73,1
1920,Se7en,2008,30000000,100125643,328125643,298125643,9.94,1
1921,Mystic River,2000,30000000,90135191,156822020,126822020,4.23,1
1922,Sisters,2017,30000000,87044645,106030660,76030660,2.53,1
1924,SpongeBob SquarePants: The Movie,2005,30000000,85416609,142051255,112051255,3.74,1
1926,The Notebook,2012,30000000,81001787,116025023,86025023,2.87,1
1927,Hannah Montana the Movie,2013,30000000,79576189,169173206,139173206,4.64,1
1928,27 Dresses,2002,30000000,76808654,160247805,130247805,4.34,1
1929,Rugrats in Paris,2014,30000000,76501438,103284813,73284813,2.44,1
1930,The Hitmanâs Bodyguard,2001,30000000,75468583,172778667,142778667,4.76,1
1932,Four Brothers,2012,30000000,74494381,92494381,62494381,2.08,1
1933,Legends of the Fall,2008,30000000,66502573,160502573,130502573,4.35,1
1934,Looper,2004,30000000,66486205,170466405,140466405,4.68,1
1936,About Schmidt,2008,30000000,65005217,107054484,77054484,2.57,1
1938,Down to Earth,2009,30000000,64172251,71172251,41172251,1.37,0
1939,Babe,2004,30000000,63658910,246100000,216100000,7.2,1
1940,Hope Springs,2011,30000000,63536011,133085295,103085295,3.44,1
1941,Forgetting Sarah Marshall,2017,30000000,63172463,105173042,75173042,2.51,1
1942,Friday Night Lights,2005,30000000,61255921,61950770,31950770,1.07,0
1943,Harlem Nights,2007,30000000,60857262,95857262,65857262,2.2,1
1944,Baby Mama,2005,30000000,60494212,64170447,34170447,1.14,0
1945,Hope Floats,2018,30000000,60110313,81529000,51529000,1.72,1
1946,Bride Wars,2010,30000000,58715510,115150424,85150424,2.84,1
1947,Without a Paddle,2001,30000000,58156435,65121280,35121280,1.17,0
1949,Darkest Hour,2015,30000000,56443120,150832086,120832086,4.03,1
1951,"P.S., I Love You",2017,30000000,53695808,155769678,125769678,4.19,1
1952,Corpse Bride,2002,30000000,53359111,114770654,84770654,2.83,1
1954,Letters to Juliet,2007,30000000,53032453,82148538,52148538,1.74,1
1956,Message in a Bottle,2005,30000000,52880016,52880016,22880016,0.76,0
1957,Southpaw,2015,30000000,52421953,94156456,64156456,2.14,1
1960,Like Mike,2018,30000000,51432423,62432423,32432423,1.08,0
1961,Naked Gun 33 1/3: The Final Insult,2012,30000000,51041856,51041856,21041856,0.7,0
1962,Atonement,2000,30000000,50980159,129779728,99779728,3.33,1
1963,A View to a Kill,2014,30000000,50327960,152627960,122627960,4.09,1
1964,Racing Stripes,2006,30000000,49772522,89955540,59955540,2.0,1
1965,Sicario,2015,30000000,46889293,84393749,54393749,1.81,1
1966,Black Rain,2010,30000000,45892212,133892212,103892212,3.46,1
1967,Full Metal Jacket,2009,30000000,45015999,45015999,15015999,0.5,0
1968,Den of Thieves,2012,30000000,44947622,80147166,50147166,1.67,1
1969,The Three Stooges,2003,30000000,44338224,54052249,24052249,0.8,0
1970,Pokemon 2000,2006,30000000,43746923,133946923,103946923,3.46,1
1971,John Wick,2011,30000000,43037835,76187790,46187790,1.54,1
1972,Glory Road,2002,30000000,42647449,42799060,12799060,0.43,0
1973,The Age of Adaline,2007,30000000,42629776,68984536,38984536,1.3,0
1975,Drag Me To Hell,2006,30000000,42100625,91388487,61388487,2.05,1
1977,Secondhand Lions,2008,30000000,42070939,47902566,17902566,0.6,0
1979,Hanna,2013,30000000,40259119,65343694,35343694,1.18,0
1980,Blue Crush,2018,30000000,40118420,51618420,21618420,0.72,0
1982,Little Shop of Horrors,2011,30000000,38747385,38747385,8747385,0.29,0
1983,Gridiron Gang,2013,30000000,38432823,41457834,11457834,0.38,0
1984,Midnight Run,2019,30000000,38413606,81613606,51613606,1.72,1
1985,Meet the Spartans,2006,30000000,38233676,84646831,54646831,1.82,1
1986,The Running Man,2018,30000000,38122000,38122000,8122000,0.27,0
1987,The Family,2010,30000000,36918811,51078541,21078541,0.7,0
1988,The 15:17 to Paris,2015,30000000,36276286,56096200,26096200,0.87,0
1989,Mortal Kombat: Annihilation,2001,30000000,35927406,51327406,21327406,0.71,0
1990,Larry Crowne,2013,30000000,35608245,61449135,31449135,1.05,0
1991,Carrie,2009,30000000,35266619,82409520,52409520,1.75,1
1992,Last Christmas,2014,30000000,35150750,121413629,91413629,3.05,1
1993,Take the Lead,2014,30000000,34742066,65390493,35390493,1.18,0
1994,Death Wish,2017,30000000,34017028,48575965,18575965,0.62,0
1995,Love and Other Drugs,2012,30000000,32367005,102716321,72716321,2.42,1
1996,Entourage,2004,30000000,32363404,46438538,16438538,0.55,0
1997,What's the Worst That Could Happen?,2011,30000000,32267774,38462071,8462071,0.28,0
1999,9,2003,30000000,31749894,48559999,18559999,0.62,0
2000,Deliver Us from Evil,2018,30000000,30577122,87956618,57956618,1.93,1
2003,The Five-Year Engagement,2011,30000000,28700285,61623819,31623819,1.05,0
2004,The Prince &amp; Me,2006,30000000,28165882,30089110,89110,0.0,0
2005,Winnie the Pooh,2016,30000000,26692846,50145607,20145607,0.67,0
2006,Bulworth,2004,30000000,26528684,29203383,-796617,-0.03,0
2007,Dumb and Dumberer: When Harry Met Lloyd,2019,30000000,26214846,28986358,-1013642,-0.03,0
2008,White Boy Rick,2010,30000000,24004833,25947983,-4052017,-0.14,0
2009,Virtuosity,2018,30000000,23998226,23998226,-6001774,-0.2,0
2010,One True Thing,2017,30000000,23337196,26708196,-3291804,-0.11,0
2011,Sanctum,2004,30000000,23209310,108957098,78957098,2.63,1
2012,My Super Ex-Girlfriend,2005,30000000,22530295,60772856,30772856,1.03,0
2013,Ballerina,2013,30000000,21858070,96890794,66890794,2.23,1
2015,Shaft,2017,30000000,21360215,21360215,-8639785,-0.29,0
2016,The Next Three Days,2006,30000000,21148651,67255916,37255916,1.24,0
2017,Proud Mary,2005,30000000,20868638,21709539,-8290461,-0.28,0
2018,Sleepless,2011,30000000,20783704,33296659,3296659,0.11,0
2019,Little Black Book,2017,30000000,20422207,21758371,-8241629,-0.27,0
2020,Assault On Precinct 13,2015,30000000,20040895,36040895,6040895,0.2,0
2021,Runner Runner,2002,30000000,19316646,60512680,30512680,1.02,0
2023,Baahubali 2: The Conclusion,2010,30000000,18985794,263502914,233502914,7.78,1
2024,Ultraviolet,2008,30000000,18522064,30962112,962112,0.03,0
2025,North Country,2004,30000000,18324242,23676771,-6323229,-0.21,0
2027,mother!,2008,30000000,17800004,42531076,12531076,0.42,0
2028,Steve Jobs,2005,30000000,17766658,35579007,5579007,0.19,0
2029,Eight Legged Freaks,2004,30000000,17266505,36722311,6722311,0.22,0
2030,Fled,2003,30000000,17192205,19892205,-10107795,-0.34,0
2031,Splice,2004,30000000,17010170,28542494,-1457506,-0.05,0
2032,88 Minutes,2005,30000000,16930884,32955399,2955399,0.1,0
2033,The Whole Ten Yards,2007,30000000,16323969,26323969,-3676031,-0.12,0
2034,Howard the Duck,2013,30000000,16295774,16295774,-13704226,-0.46,0
2037,Godsend,2016,30000000,14334645,16873925,-13126075,-0.44,0
2038,Alex &amp; Emma,2001,30000000,14208384,15358583,-14641417,-0.49,0
2039,Wicker Park,2013,30000000,13001257,21577076,-8422924,-0.28,0
2040,The New World,2011,30000000,12712093,26184400,-3815600,-0.13,0
2041,Evening,2009,30000000,12406646,12885574,-17114426,-0.57,0
2042,The Last Stand,2004,30000000,12050299,48330757,18330757,0.61,0
2043,In Dreams,2017,30000000,12017369,12017369,-17982631,-0.6,0
2044,Wing Commander,2005,30000000,11578022,11578022,-18421978,-0.61,0
2045,CafÃ© Society,2017,30000000,11103205,44359512,14359512,0.48,0
2046,Antitrust,2019,30000000,10965209,17865209,-12134791,-0.4,0
2047,Dead Man Down,2009,30000000,10895295,19599974,-10400026,-0.35,0
2048,Hoodwinked Too: Hood vs. Evil,2011,30000000,10143779,23353111,-6646889,-0.22,0
2049,Dragonball Evolution,2002,30000000,9362785,58228460,28228460,0.94,0
2050,First Daughter,2019,30000000,9055010,10419084,-19580916,-0.65,0
2051,The Lost City of Z,2018,30000000,8574339,17121823,-12878177,-0.43,0
2053,The Space Between Us,2018,30000000,7885294,16481405,-13518595,-0.45,0
2054,Anna,2017,30000000,7743794,30982979,982979,0.03,0
2056,Barney's Version,2018,30000000,7502560,8845575,-21154425,-0.71,0
2057,Trapped,2007,30000000,6916869,7005468,-22994532,-0.77,0
2058,The Current War: Directorâs Cut,2004,30000000,5978673,11557001,-18442999,-0.61,0
2059,Kin,2003,30000000,5718096,10383524,-19616476,-0.65,0
2060,Once Upon a Time in America,2005,30000000,5321508,5575648,-24424352,-0.81,0
2061,Johnny English Strikes Again,2006,30000000,4412170,159423384,129423384,4.31,1
2062,Stronger,2006,30000000,4211129,8786287,-21213713,-0.71,0
2064,Replicas,2017,30000000,4046429,9037427,-20962573,-0.7,0
2065,The Assassination of Jesse James by the Coward …,2007,30000000,3909149,15313631,-14686369,-0.49,0
2066,The Merchant of Venice,2010,30000000,3765585,18765585,-11234415,-0.37,0
2067,The Good Thief,2011,30000000,3517797,6460758,-23539242,-0.78,0
2069,Miss Potter,2015,30000000,3005605,35891257,5891257,0.2,0
2070,Wu ji,2014,30000000,669625,35869934,5869934,0.2,0
2073,DOA: Dead or Alive,2015,30000000,480314,7755686,-22244314,-0.74,0
2074,Le Petit Nicolas,2007,30000000,201857,52339566,22339566,0.74,0
2075,Xinhai geming,2003,30000000,135739,8593154,-21406846,-0.71,0
2080,Grace of Monaco,2018,30000000,0,25199891,-4800109,-0.16,0
2081,Overdrive,2016,30000000,0,11247280,-18752720,-0.63,0
2088,Walk the Line,2020,29000000,119519402,187707495,158707495,5.47,1
2089,Night School,2008,29000000,77339130,103113446,74113446,2.56,1
2090,The Boss,2004,29000000,63077560,78652207,49652207,1.71,1
2091,12 Monkeys,2002,29000000,57141459,168841459,139841459,4.82,1
2092,Once Upon a Time in Mexico,2002,29000000,56330657,97413527,68413527,2.36,1
2093,Keeping the Faith,2009,29000000,37036404,45336404,16336404,0.56,0
2096,The Borrowers,2005,29000000,22619589,54045832,25045832,0.86,0
2099,Seed of Chucky,2015,29000000,17016190,24716190,-4283810,-0.15,0
2100,Serving Sara,2017,29000000,16930185,20146150,-8853850,-0.31,0
2103,Cry Freedom,2001,29000000,5899797,25899797,-3100203,-0.11,0
2105,The Jacket,2013,28500000,6301131,15452978,-13047022,-0.46,0
2106,Aladdin,2015,28000000,217350219,504050219,476050219,17.0,1
2107,Indiana Jones and the Temple of Doom,2019,28000000,179880271,333080271,305080271,10.9,1
2108,Straight Outta Compton,2008,28000000,161197785,202182981,174182981,6.22,1
2109,Girls Trip,2014,28000000,115108515,140886353,112886353,4.03,1
2110,The Rugrats Movie,2004,28000000,100494685,140894685,112894685,4.03,1
2111,Die Hard,2013,28000000,81350242,139109346,111109346,3.97,1
2112,Along Came a Spider,2001,28000000,74058698,105159085,77159085,2.76,1
2113,A Bad Moms Christmas,2004,28000000,72110659,127710550,99710550,3.56,1
2115,The Big Short,2018,28000000,70259870,133162752,105162752,3.76,1
2116,Scary Stories to Tell in the Dark,2001,28000000,68947075,95607360,67607360,2.41,1
2117,Role Models,2003,28000000,67300955,94500826,66500826,2.38,1
2118,"Alexander and the Terrible, Horrible, No Good, …",2001,28000000,66954149,101379287,73379287,2.62,1
2119,Miracle,2010,28000000,64378093,64474705,36474705,1.3,0
2120,Last Vegas,2001,28000000,63914167,112914167,84914167,3.03,1
2122,Dawn of the Dead,2007,28000000,58990765,103452875,75452875,2.69,1
2124,Tag,2005,28000000,54730625,77024944,49024944,1.75,1
2125,The Royal Tenenbaums,2011,28000000,52353636,71430876,43430876,1.55,1
2126,Identity,2000,28000000,52131264,82119036,54119036,1.93,1
2129,Zoolander,2014,28000000,45172250,60780981,32780981,1.17,0
2130,Timecop,2013,28000000,44853581,102053581,74053581,2.64,1
2131,No Reservations,2007,28000000,43107979,91943956,63943956,2.28,1
2132,Hocus Pocus,2014,28000000,39360491,39360491,11360491,0.41,0
2133,Pride &amp; Prejudice,2010,28000000,38372662,126549607,98549607,3.52,1
2134,30 Minutes or Less,2014,28000000,37053924,40966716,12966716,0.46,0
2135,Dracula 2000,2006,28000000,33000377,33000377,5000377,0.18,0
2136,Blade Runner,2000,28000000,32656328,39352610,11352610,0.41,0
2137,Rob Roy,2015,28000000,31390587,31390587,3390587,0.12,0
2138,3 Days to Kill,2003,28000000,30697999,38959900,10959900,0.39,0
2139,Kick-Ass 2,2016,28000000,28795985,63129909,35129909,1.25,0
2141,A Walk Among the Tombstones,2001,28000000,26017685,62108587,34108587,1.22,0
2143,Brick Mansions,2015,28000000,20396829,73421224,45421224,1.62,1
2145,Lost Souls,2008,28000000,16779636,31320293,3320293,0.12,0
2146,American Ultra,2007,28000000,14439985,30295028,2295028,0.08,0
2148,Pride and Prejudice and Zombies,2009,28000000,10907291,16638300,-11361700,-0.41,0
2149,"Mystery, Alaska",2008,28000000,8891623,8891623,-19108377,-0.68,0
2150,John Carpenterâs Ghosts of Mars,2012,28000000,8434601,8434601,-19565399,-0.7,0
2152,Our Brand is Crisis,2006,28000000,7002261,8594558,-19405442,-0.69,0
2153,Kundun,2007,28000000,5686694,5686694,-22313306,-0.8,0
2154,How to Lose Friends &amp; Alienate People,2011,28000000,2775593,12031443,-15968557,-0.57,0
2157,Octopussy,2019,27500000,67900000,187500000,160000000,5.82,1
2158,My Sister's Keeper,2002,27500000,49200230,96673002,69173002,2.52,1
2162,Notes on a Scandal,2008,27500000,17510118,50578411,23078411,0.84,0
2163,Rendition,2016,27500000,9736045,26939925,-560075,-0.02,0
2164,Anonymous,2002,27500000,4463292,15815509,-11684491,-0.42,0
2165,Limitless,2011,27000000,79249455,155564919,128564919,4.76,1
2167,Annabelle Comes Home,2006,27000000,74152591,228517113,201517113,7.46,1
2171,The Jungle Book,2008,27000000,44342956,44342956,17342956,0.64,0
2172,The Sisterhood of the Traveling Pants 2,2010,27000000,44089964,44270131,17270131,0.64,0
2173,Money Monster,2005,27000000,41012075,93466095,66466095,2.46,1
2176,Lake Placid,2004,27000000,31770413,31770413,4770413,0.18,0
2177,Lucky Number Slevin,2007,27000000,22495466,55495466,28495466,1.06,0
2178,The Right Stuff,2002,27000000,21500000,21500000,-5500000,-0.2,0
2180,Dark City,2005,27000000,14435076,27257061,257061,0.01,0
2181,The Duchess,2008,27000000,13848978,45160110,18160110,0.67,0
2182,Case 39,2003,27000000,13261851,28773827,1773827,0.07,0
2183,The Honeymooners,2019,27000000,12834849,13174426,-13825574,-0.51,0
2184,Return to Oz,2016,27000000,10618813,10618813,-16381187,-0.61,0
2185,The Newton Boys,2009,27000000,10341093,10341093,-16658907,-0.62,0
2186,Suspect Zero,2003,27000000,8712564,8723600,-18276400,-0.68,0
2187,Martian Child,2005,27000000,7500310,9352089,-17647911,-0.65,0
2190,Mindhunters,2008,27000000,4476235,16566235,-10433765,-0.39,0
2196,Paul Blart: Mall Cop,2011,26000000,146336178,185904750,159904750,6.15,1
2198,The 40 Year-old Virgin,2013,26000000,109449237,176276839,150276839,5.78,1
2199,Shakespeare in Love,2003,26000000,100317794,279500000,253500000,9.75,1
2200,Kindergarten Cop,2000,26000000,91457688,202000000,176000000,6.77,1
2201,Pineapple Express,2004,26000000,87341380,102404019,76404019,2.94,1
2202,Philadelphia,2010,26000000,77324422,201324422,175324422,6.74,1
2203,Ever After: A Cinderella Story,2012,26000000,65705772,65705772,39705772,1.53,1
2204,Flatliners,2002,26000000,61308153,61308153,35308153,1.36,0
2206,Red Eye,2009,26000000,57891803,96666486,70666486,2.72,1
2207,New Yearâs Eve,2014,26000000,54544638,146850273,120850273,4.65,1
2208,A Bridge Too Far,2004,26000000,50800000,50800000,24800000,0.95,0
2209,Pain &amp; Gain,2016,26000000,49875291,81275291,55275291,2.13,1
2210,Final Destination 2,2001,26000000,46896664,90396664,64396664,2.48,1
2211,"O Brother, Where Art Thou?",2012,26000000,45506619,75763814,49763814,1.91,1
2212,In Good Company,2004,26000000,45489752,63489752,37489752,1.44,0
2214,Lawless,2015,26000000,37397291,54393687,28393687,1.09,0
2215,Clockstoppers,2019,26000000,36985501,38788828,12788828,0.49,0
2216,Silverado,2001,26000000,33200000,33200000,7200000,0.28,0
2217,Brothers,2013,26000000,28544157,45043870,19043870,0.73,0
2219,Agent Cody Banks 2: Destination London,2013,26000000,23514247,28703083,2703083,0.1,0
2221,Original Sin,2015,26000000,16521410,16521410,-9478590,-0.36,0
2222,The Raven,2015,26000000,16008272,30601801,4601801,0.18,0
2223,Welcome to Mooseport,2015,26000000,14469428,14494770,-11505230,-0.44,0
2225,Self/Less,2005,26000000,12279691,33667319,7667319,0.29,0
2226,Motherless Brooklyn,2008,26000000,9277736,18132937,-7867063,-0.3,0
2227,The Curse of the Jade Scorpion,2004,26000000,7496522,18496522,-7503478,-0.29,0
2232,Viy,2008,26000000,0,34246770,8246770,0.32,0
2237,W.,2003,25100000,25534493,28575778,3475778,0.14,0
2238,The Passion of the Christ,2004,25000000,370782930,622341120,597341120,23.89,1
2239,Mrs. Doubtfire,2004,25000000,219195051,441286003,416286003,16.65,1
2240,Rain Man,2003,25000000,172825435,412800000,387800000,15.51,1
2241,The Help,2007,25000000,169705587,213120004,188120004,7.52,1
2242,Hidden Figures,2001,25000000,169607287,231771716,206771716,8.27,1
2243,Gran Torino,2008,25000000,148095302,274543085,249543085,9.98,1
2244,Taken,2010,25000000,145000989,226941585,201941585,8.08,1
2246,The Bodyguard,2012,25000000,121945720,410945720,385945720,15.44,1
2248,"Legally Blonde 2: Red, White &amp; Blonde",2007,25000000,90639088,125339088,100339088,4.01,1
2249,Scooby-Doo 2: Monsters Unleashed,2001,25000000,84185387,180856996,155856996,6.23,1
2250,Anchorman: The Legend of Ron Burgundy,2000,25000000,84136909,89476265,64476265,2.58,1
2251,Freddy vs. Jason,2011,25000000,82622655,114576403,89576403,3.58,1
2252,Bridge to Terabithia,2012,25000000,82234139,137984788,112984788,4.52,1
2253,Jimmy Neutron: Boy Genius,2017,25000000,80936232,102992536,77992536,3.12,1
2254,Cloverfield,2012,25000000,80048433,171302226,146302226,5.85,1
2256,Teenage Mutant Ninja Turtles II: The Secret of …,2000,25000000,78656813,78656813,53656813,2.15,1
2257,Parental Guidance,2006,25000000,77267296,120832383,95832383,3.83,1
2258,The Untouchables,2006,25000000,76270454,76270454,51270454,2.05,1
2259,No Country for Old Men,2011,25000000,74273505,164035753,139035753,5.56,1
2260,Bridget Jones's Diary,2013,25000000,71500556,281527158,256527158,10.26,1
2261,Chocolat,2004,25000000,71309760,152500343,127500343,5.1,1
2262,No Strings Attached,2012,25000000,70662220,149228078,124228078,4.97,1
2263,Contraband,2005,25000000,66528000,98406855,73406855,2.94,1
2265,The Lucky One,2008,25000000,60457138,96633833,71633833,2.87,1
2266,Tombstone,2003,25000000,56505065,56505065,31505065,1.26,0
2267,Romeo Must Die,2006,25000000,55973336,91036760,66036760,2.64,1
2269,Final Destination 3,2014,25000000,54098051,112798051,87798051,3.51,1
2273,The Grey,2015,25000000,51580136,81249176,56249176,2.25,1
2275,Cobra,2002,25000000,49042224,49042224,24042224,0.96,0
2277,Agent Cody Banks,2007,25000000,47545060,58240458,33240458,1.33,0
2278,Nanny McPhee,2002,25000000,47279279,128745578,103745578,4.15,1
2279,Goodfellas,2003,25000000,46743809,46777347,21777347,0.87,0
2280,The Giver,2005,25000000,45090374,66540205,41540205,1.66,1
2281,Scarface,2002,25000000,44942821,44942821,19942821,0.8,0
2282,Nothing To Lose,2013,25000000,44480039,64594061,39594061,1.58,1
2283,The Last Emperor,2001,25000000,43984987,44005073,19005073,0.76,0
2284,The Night Before,2014,25000000,43035725,52568099,27568099,1.1,0
2285,The Beverly Hillbillies,2005,25000000,42222647,55598481,30598481,1.22,0
2286,The Hours,2019,25000000,41675994,97030468,72030468,2.88,1
2287,Money Talks,2003,25000000,41076865,41076865,16076865,0.64,0
2288,There Will Be Blood,2003,25000000,40222514,77208711,52208711,2.09,1
2289,The Wild Thornberrys Movie,2018,25000000,40108697,60694737,35694737,1.43,0
2290,Rugrats Go Wild,2007,25000000,39402572,55443032,30443032,1.22,0
2291,The Sisterhood of the Traveling Pants,2003,25000000,39053061,41560117,16560117,0.66,0
2292,Undercover Brother,2006,25000000,38230435,40796145,15796145,0.63,0
2293,August: Osage County,2014,25000000,37738810,50738810,25738810,1.03,0
2294,Kiss of the Dragon,2007,25000000,36833473,36833473,11833473,0.47,0
2295,Million Dollar Arm,2016,25000000,36447959,39217912,14217912,0.57,0
2297,Just Mercy,2017,25000000,36001502,50401502,25401502,1.02,0
2298,What a Girl Wants,2007,25000000,35990505,37216643,12216643,0.49,0
2299,Jeepers Creepers 2,2004,25000000,35623801,119923801,94923801,3.8,1
2300,Peppermint,2011,25000000,35418723,51800758,26800758,1.07,0
2304,The Gambler,2014,25000000,33680992,38718031,13718031,0.55,0
2306,Motherâs Day,2017,25000000,32492859,52367022,27367022,1.09,0
2307,Bride of Chucky,2009,25000000,32404188,50692188,25692188,1.03,0
2308,Fist Fight,2001,25000000,32187017,40286416,15286416,0.61,0
2310,Anacondas: The Hunt for the Blood Orchid,2005,25000000,31526393,70326393,45326393,1.81,1
2311,The Sitter,2011,25000000,30542576,38749404,13749404,0.55,0
2312,Elizabeth,2010,25000000,30082699,82150642,57150642,2.29,1
2313,Tora! Tora! Tora!,2009,25000000,29548291,29548291,4548291,0.18,0
2314,Spice World,2007,25000000,29342592,56042592,31042592,1.24,0
2316,The Shawshank Redemption,2005,25000000,28241469,28417060,3417060,0.14,0
2318,Dance Flick,2011,25000000,25794018,32224624,7224624,0.29,0
2319,Crocodile Dundee in Los Angeles,2015,25000000,25590119,39393111,14393111,0.58,0
2320,Kingpin,2011,25000000,25023424,32223424,7223424,0.29,0
2321,Ice Princess,2017,25000000,24381334,25732334,732334,0.03,0
2322,Don't Be Afraid of the Dark,2002,25000000,24046682,39126427,14126427,0.57,0
2323,The Losers,2004,25000000,23591432,29863840,4863840,0.19,0
2324,Fighting,2017,25000000,23091010,32831707,7831707,0.31,0
2325,War,2008,25000000,22486409,40686409,15686409,0.63,0
2326,Don Juan DeMarco,2016,25000000,22032635,22032635,-2967365,-0.12,0
2327,A Lot Like Love,2013,25000000,21835784,41921590,16921590,0.68,0
2328,He Got Game,2006,25000000,21567853,22411948,-2588052,-0.1,0
2329,The Eagle,2018,25000000,19490041,38993548,13993548,0.56,0
2331,Shark Night 3D,2002,25000000,18877153,18877153,-6122847,-0.24,0
2334,Eurotrip,2005,25000000,17718223,20718223,-4281777,-0.17,0
2335,Father Figures,2009,25000000,17501244,21038441,-3961559,-0.16,0
2336,The Ruins,2000,25000000,17432844,22910563,-2089437,-0.08,0
2337,Masterminds,2010,25000000,17356894,30850666,5850666,0.23,0
2338,The Counselor,2004,25000000,16973715,71009334,46009334,1.84,1
2339,Unaccompanied Minors,2008,25000000,16655224,21970831,-3029169,-0.12,0
2341,"Bright Lights, Big City",2002,25000000,16118077,16118077,-8881923,-0.36,0
2342,Half Past Dead,2007,25000000,15567860,19233280,-5766720,-0.23,0
2343,Legend,2011,25000000,15502112,23506237,-1493763,-0.06,0
2345,The Greatest Game Ever Played,2017,25000000,15331289,15468266,-9531734,-0.38,0
2346,The Box,2012,25000000,15051977,34356760,9356760,0.37,0
2347,The Next Best Thing,2015,25000000,14983572,24355762,-644238,-0.03,0
2349,The Girl Next Door,2011,25000000,14589444,31635150,6635150,0.27,0
2350,Fly Me To the Moon,2002,25000000,14543943,43530281,18530281,0.74,0
2351,Maximum Risk,2005,25000000,14102929,51702929,26702929,1.07,0
2354,Warrior,2008,25000000,13657115,24215385,-784615,-0.03,0
2356,Battle of the Sexes,2002,25000000,12638526,18445379,-6554621,-0.26,0
2357,Cirque du Soleil: Worlds Away,2011,25000000,12512862,28012862,3012862,0.12,0
2359,Lifeforce,2002,25000000,11603545,11603545,-13396455,-0.54,0
2362,The Lords of Dogtown,2019,25000000,11273517,13424365,-11575635,-0.46,0
2363,Big Trouble in Little China,2009,25000000,11100000,11100000,-13900000,-0.56,0
2364,Michael Collins,2018,25000000,11092559,27572844,2572844,0.1,0
2365,Stop-Loss,2007,25000000,10915744,11229035,-13770965,-0.55,0
2366,Gettysburg,2019,25000000,10731997,10731997,-14268003,-0.57,0
2368,Straw Dogs,2005,25000000,10324441,11253821,-13746179,-0.55,0
2369,Brokedown Palace,2001,25000000,10115014,11115766,-13884234,-0.56,0
2370,Possession,2005,25000000,10103647,14805812,-10194188,-0.41,0
2371,Mrs. Winterbourne,2008,25000000,10039566,10039566,-14960434,-0.6,0
2373,Serenity,2005,25000000,8547045,13008804,-11991196,-0.48,0
2374,The Road,2008,25000000,8114270,29206732,4206732,0.17,0
2375,Beautiful Boy,2018,25000000,7634767,13314562,-11685438,-0.47,0
2376,The Hoax,2011,25000000,7164995,7164995,-17835005,-0.71,0
2377,Captive State,2017,25000000,5958315,9186073,-15813927,-0.63,0
2378,Sheena,2006,25000000,5778353,5778353,-19221647,-0.77,0
2379,Underclassman,2015,25000000,5654777,5654777,-19345223,-0.77,0
2380,Say It Isn't So,2009,25000000,5516708,5516708,-19483292,-0.78,0
2381,The World's Fastest Indian,2015,25000000,5128124,18991288,-6008712,-0.24,0
2382,Deception,2009,25000000,4598506,12850033,-12149967,-0.49,0
2387,Carnage,2012,25000000,2546747,38112154,13112154,0.52,0
2388,Tulip Fever,2010,25000000,2455635,6792768,-18207232,-0.73,0
2390,Legend,2017,25000000,1872994,42425450,17425450,0.7,0
2391,Bad Lieutenant: Port of Call New Orleans,2011,25000000,1702112,12413949,-12586051,-0.5,0
2397,On the Road,2012,25000000,720828,9313302,-15686698,-0.63,0
2403,Matilda,2014,25000000,0,9370285,-15629715,-0.63,0
2404,La vÃ©ritable histoire du Chat BottÃ©,2016,25000000,0,8208594,-16791406,-0.67,0
2405,The Professor and the Madman,2000,25000000,0,6192599,-18807401,-0.75,0
2411,Dangerous Liaisons,2007,24200000,17000,10447579,-13752421,-0.57,0
2413,Scream 2,2000,24000000,101363301,172363301,148363301,6.18,1
2414,The Addams Family,2009,24000000,97185807,200096676,176096676,7.34,1
2415,Old School,2008,24000000,75155000,86737464,62737464,2.61,1
2416,Rocky Balboa,2001,24000000,70269899,156229050,132229050,5.51,1
2418,Fences,2000,24000000,57682904,64282881,40282881,1.68,1
2419,The Whole Nine Yards,2010,24000000,57262492,85527867,61527867,2.56,1
2420,Footloose,2010,24000000,51802742,62989834,38989834,1.62,1
2422,Point Break,2004,24000000,43218387,83531958,59531958,2.48,1
2424,I Still Know What You Did Last Summer,2000,24000000,40020622,40020622,16020622,0.67,0
2425,Hitman,2014,24000000,39687694,99135571,75135571,3.13,1
2426,"Hello, Dolly",2011,24000000,33208099,33208099,9208099,0.38,0
2428,The Men Who Stare at Goats,2013,24000000,32428195,67348218,43348218,1.81,1
2429,Zack and Miri Make a Porno,2004,24000000,31457946,36856306,12856306,0.54,0
2430,Double Take,2005,24000000,29823162,29823162,5823162,0.24,0
2433,Piranha 3D,2005,24000000,25003155,83660160,59660160,2.49,1
2434,Faster,2009,24000000,23240020,35792945,11792945,0.49,0
2438,Ready to Rumble,2018,24000000,12372410,12372410,-11627590,-0.48,0
2440,I Don't Know How She Does It,2015,24000000,9659074,24474463,474463,0.02,0
2441,Play it to the Bone,2000,24000000,8427204,8427204,-15572796,-0.65,0
2443,Beyond the Sea,2011,24000000,6144806,8292914,-15707086,-0.65,0
2444,Hauru no ugoku shiro,2000,24000000,4710455,237814327,213814327,8.91,1
2449,Zombieland,2012,23600000,75590286,102236596,78636596,3.33,1
2450,Star Wars Ep. V: The Empire Strikes Back,2012,23000000,290271960,547969004,524969004,22.82,1
2452,The Naked Gun 2Â½: The Smell of Fear,2004,23000000,86930411,86930411,63930411,2.78,1
2453,Green Book,2016,23000000,85080171,319543432,296543432,12.89,1
2455,The Wedding Ringer,2000,23000000,64460211,80171596,57171596,2.49,1
2457,King Kong,2004,23000000,52614445,90614445,67614445,2.94,1
2458,The Ides of March,2008,23000000,40962534,77735925,54735925,2.38,1
2461,Someone Like You,2007,23000000,27338033,38684906,15684906,0.68,0
2462,Her,2009,23000000,25568251,48043998,25043998,1.09,0
2463,Joy Ride,2009,23000000,21973182,22204890,-795110,-0.03,0
2464,Kari gurashi no Arietti,2013,23000000,19192510,151496097,128496097,5.59,1
2465,Haywire,2008,23000000,18942396,36374700,13374700,0.58,0
2466,Anywhere But Here,2017,23000000,18653615,18653615,-4346385,-0.19,0
2467,Vanity Fair,2011,23000000,16123851,19123851,-3876149,-0.17,0
2469,Jaws 4: The Revenge,2007,23000000,15728335,15728335,-7271665,-0.32,0
2470,The Crew,2016,23000000,13019253,13019253,-9980747,-0.43,0
2471,Marvin's Room,2014,23000000,12803305,12803305,-10196695,-0.44,0
2475,Harley Davidson and the Marlboro Man,2018,23000000,7018525,7018525,-15981475,-0.69,0
2476,In the Valley of Elah,2007,23000000,6777741,24489150,1489150,0.06,0
2477,Coco avant Chanel,2002,23000000,6113834,50813834,27813834,1.21,0
2479,Redemption,2014,23000000,36686,13593473,-9406527,-0.41,0
2481,ChÄi dÃ n zhuÄnjiÄ,2014,23000000,0,58807172,35807172,1.56,1
2483,Spaceballs,2003,22700000,38119483,38119483,15419483,0.68,0
2485,Nocturnal Animals,2012,22500000,10663357,32398681,9898681,0.44,0
2486,The Water Diviner,2001,22500000,4200117,31054727,8554727,0.38,0
2487,Ghost,2019,22000000,217631306,517600000,495600000,22.53,1
2488,There's Something About Mary,2005,22000000,176484651,369884651,347884651,15.81,1
2489,The Santa Clause,2009,22000000,144833357,189800000,167800000,7.63,1
2490,The Nun,2013,22000000,117450119,363391647,341391647,15.52,1
2491,The Game Plan,2016,22000000,90648202,146590987,124590987,5.66,1
2492,The Rookie,2001,22000000,75600072,80491516,58491516,2.66,1
2494,Son of God,2008,22000000,59700064,70949793,48949793,2.22,1
2495,The Animal,2005,22000000,55762229,55762229,33762229,1.53,1
2496,The Hundred-Foot Journey,2017,22000000,54235441,94270488,72270488,3.29,1
2497,Gandhi,2008,22000000,52767889,127767889,105767889,4.81,1
2498,Underworld,2013,22000000,51970690,95708457,73708457,3.35,1
2499,The Net,2008,22000000,50621733,110521733,88521733,4.02,1
2500,Diary of a Wimpy Kid: Dog Days,2001,22000000,49008662,77229695,55229695,2.51,1
2502,The Gentlemen,2001,22000000,36296854,111800189,89800189,4.08,1
2503,Derailed,2015,22000000,36020063,57520063,35520063,1.61,1
2505,Delivery Man,2001,22000000,30659817,70536870,48536870,2.21,1
2506,"Hail, Caesar!",2012,22000000,30080225,64220196,42220196,1.92,1
2507,Jay and Silent Bob Strike Back,2000,22000000,30059386,33762400,11762400,0.53,0
2508,Shadowlands,2004,22000000,25842377,25842377,3842377,0.17,0
2509,Traitor,2017,22000000,23530831,27882226,5882226,0.27,0
2510,Deuce Bigalow: European Gigolo,2013,22000000,22400154,45273464,23273464,1.06,0
2513,Homefront,2017,22000000,20158492,51695362,29695362,1.35,0
2514,Igor,2001,22000000,19528602,31013349,9013349,0.41,0
2516,Summer of Sam,2005,22000000,19288130,19288130,-2711870,-0.12,0
2517,The Glass House,2007,22000000,17951431,22861785,861785,0.04,0
2518,The Transporter Refueled,2014,22000000,16029670,69698495,47698495,2.17,1
2519,The Island,2010,22000000,15716828,15716828,-6283172,-0.29,0
2520,Josie and the Pussycats,2006,22000000,14252830,14307223,-7692777,-0.35,0
2521,Hit &amp; Run,2013,22000000,13749300,17216955,-4783045,-0.22,0
2523,I Heart Huckabees,2007,22000000,12784713,20034713,-1965287,-0.09,0
2524,"Roman J. Israel, Esq.",2007,22000000,11962712,12967012,-9032988,-0.41,0
2527,Dudley Do-Right,2012,22000000,9818792,9818792,-12181208,-0.55,0
2528,Just Getting Started,2012,22000000,6069605,6756412,-15243588,-0.69,0
2529,Megiddo: Omega Code 2,2018,22000000,6047691,6047691,-15952309,-0.73,0
2533,Before I Go to Sleep,2010,22000000,3242457,19563579,-2436421,-0.11,0
2535,Joyeux NoÃ«l,2001,22000000,1054361,23134075,1134075,0.05,0
2536,Metegol,2010,22000000,0,34061097,12061097,0.55,0
2537,Sorcerer,2007,21600000,12000000,12005968,-9594032,-0.44,0
2539,Michael Clayton,2017,21500000,49033882,92987651,71487651,3.33,1
2540,Arlington Road,2002,21500000,24419219,24419219,2919219,0.14,0
2541,My Fellow Americans,2008,21500000,22331846,22331846,831846,0.04,0
2542,To Rome with Love,2011,21500000,16684352,74326015,52826015,2.46,1
2543,Silver Linings Playbook,2017,21000000,132092958,236412453,215412453,10.26,1
2546,"South Park: Bigger, Longer &amp; Uncut",2008,21000000,52037603,52037603,31037603,1.48,0
2547,Firefox,2009,21000000,45785720,45785720,24785720,1.18,0
2548,Death at a Funeral,2002,21000000,42739347,48977233,27977233,1.33,0
2549,Teenage Mutant Ninja Turtles III,2011,21000000,42273609,42273609,21273609,1.01,0
2550,Hardball,2017,21000000,40222729,43728560,22728560,1.08,0
2552,Freedom Writers,2015,21000000,36605602,43632609,22632609,1.08,0
2553,The Hustle,2019,21000000,35417038,97896107,76896107,3.66,1
2554,Kidnap,2019,21000000,30718107,34836080,13836080,0.66,0
2557,Tinker Tailor Soldier Spy,2006,21000000,24149393,81452811,60452811,2.88,1
2560,The Rage: Carrie 2,2019,21000000,17760244,17760244,-3239756,-0.15,0
2571,The Best Little Whorehouse in Texas,2016,20500000,69701637,69701637,49201637,2.4,1
2572,Pulse,2019,20500000,20264436,30241435,9741435,0.48,0
2574,Beauty and the Beast,2008,20000000,206333165,438707031,418707031,20.94,1
2575,Us,2014,20000000,175084580,256169079,236169079,11.81,1
2576,Home Alone 2: Lost in New York,2019,20000000,173585516,358994850,338994850,16.95,1
2577,Close Encounters of the Third Kind,2005,20000000,169100479,340800479,320800479,16.04,1
2578,Beverly Hills Cop II,2011,20000000,153665036,276665036,256665036,12.83,1
2579,La La Land,2003,20000000,151101803,444005853,424005853,21.2,1
2580,The Conjuring,2007,20000000,137400141,317886012,297886012,14.89,1
2582,Wonder,2019,20000000,132422809,312755215,292755215,14.64,1
2583,The Silence of the Lambs,2016,20000000,130726716,275726716,255726716,12.79,1
2585,Jackass 3D,2004,20000000,117229692,171685793,151685793,7.58,1
2586,Bad Moms,2009,20000000,113257297,180998716,160998716,8.05,1
2587,Glass,2003,20000000,111048468,246999039,226999039,11.35,1
2588,Jaws 2,2012,20000000,102922376,208900376,188900376,9.45,1
2589,Beverly Hills Chihuahua,2010,20000000,94514402,154218168,134218168,6.71,1
2590,Tammy,2010,20000000,84525432,96407655,76407655,3.82,1
2592,Are We There Yet?,2017,20000000,82674398,98114471,78114471,3.91,1
2593,The Descendants,2013,20000000,82624961,175507800,155507800,7.78,1
2594,School of Rock,2002,20000000,81261177,131944672,111944672,5.6,1
2595,Disturbia,2016,20000000,80818974,118537627,98537627,4.93,1
2596,Free Willy,2019,20000000,77698625,153698625,133698625,6.68,1
2597,Tyler Perryâs A Madea Family Funeral,2016,20000000,73257045,74781999,54781999,2.74,1
2599,Mortal Kombat,2018,20000000,70433227,122133227,102133227,5.11,1
2600,White Chicks,2015,20000000,69148997,111448997,91448997,4.57,1
2602,Holes,2006,20000000,67383924,71232214,51232214,2.56,1
2603,Tyler Perry's Madea's Witness Protection,2002,20000000,65653242,66950887,46950887,2.35,1
2604,The Last Song,2003,20000000,62950384,92678948,72678948,3.63,1
2605,Why Did I Get Married Too?,2007,20000000,60095852,60831067,40831067,2.04,1
2606,La vita Ã¨ bella,2017,20000000,57598247,229375361,209375361,10.47,1
2607,The Shack,2005,20000000,57386418,96908458,76908458,3.85,1
2608,12 Years a Slave,2000,20000000,56671993,180790756,160790756,8.04,1
2609,Drumline,2015,20000000,56398162,56398875,36398875,1.82,1
2610,Me Before You,2019,20000000,56245075,208265198,188265198,9.41,1
2611,What Men Want,2018,20000000,54611903,69911903,49911903,2.5,1
2612,Barbershop: The Next Cut,2015,20000000,54030051,54404202,34404202,1.72,1
2613,Edward Scissorhands,2008,20000000,53976987,53976987,33976987,1.7,1
2614,A Simple Favor,2009,20000000,53548586,97628717,77628717,3.88,1
2615,Selma,2017,20000000,52076908,66776576,46776576,2.34,1
2616,Popeye,2007,20000000,49823037,49823037,29823037,1.49,0
2617,Date Movie,2008,20000000,48548426,85146165,65146165,3.26,1
2618,Peter Pan: Return to Neverland,2006,20000000,48430258,109862682,89862682,4.49,1
2619,The Jungle Book 2,2016,20000000,47901582,139924202,119924202,6.0,1
2623,The Tigger Movie,2006,20000000,45542421,96147688,76147688,3.81,1
2624,Spotlight,2016,20000000,45055776,91902438,71902438,3.6,1
2625,Queen &amp; Slim,2010,20000000,43808310,47679629,27679629,1.38,0
2627,Max,2010,20000000,42656255,43658157,23658157,1.18,0
2629,Orphan,2011,20000000,41596251,78769428,58769428,2.94,1
2630,The Star,2004,20000000,40847995,62758010,42758010,2.14,1
2631,Epic Movie,2013,20000000,39739367,86858578,66858578,3.34,1
2632,Lakeview Terrace,2006,20000000,39263506,44821299,24821299,1.24,0
2633,The Grudge 2,2014,20000000,39143839,70743839,50743839,2.54,1
2634,Nerve,2008,20000000,38583626,85583945,65583945,3.28,1
2635,Conan the Barbarian,2004,20000000,38264085,79114085,59114085,2.96,1
2637,Bill &amp; Ted's Bogus Journey,2013,20000000,37537675,37537675,17537675,0.88,0
2638,Man of the Year,2010,20000000,37442180,41342180,21342180,1.07,0
2639,Risen,2008,20000000,36880033,46255763,26255763,1.31,0
2641,The Black Hole,2011,20000000,35841901,35841901,15841901,0.79,0
2642,The American,2002,20000000,35606376,67950723,47950723,2.4,1
2643,Selena,2010,20000000,35450113,35450113,15450113,0.77,0
2644,A Very Harold &amp; Kumar 3D Christmas,2008,20000000,35061031,36265745,16265745,0.81,0
2646,Texas Chainsaw 3D,2009,20000000,34341945,47666013,27666013,1.38,0
2647,Babel,2000,20000000,34302837,132121212,112121212,5.61,1
2648,This is Where I Leave You,2006,20000000,34296320,41296320,21296320,1.06,0
2649,Doubt,2008,20000000,33446470,53191101,33191101,1.66,1
2651,Copycat,2008,20000000,32051917,32051917,12051917,0.6,0
2652,Scary Movie V,2013,20000000,32015787,78613981,58613981,2.93,1
2654,Milk,2010,20000000,31841299,57293371,37293371,1.86,1
2655,Paint Your Wagon,2007,20000000,31678778,31678778,11678778,0.58,0
2656,The Debt,2010,20000000,31177548,46604054,26604054,1.33,0
2657,Ghost Ship,2018,20000000,30113491,68349884,48349884,2.42,1
2658,Daybreakers,2014,20000000,30101577,51445503,31445503,1.57,1
2659,The Bank Job,2006,20000000,30060660,66143005,46143005,2.31,1
2660,Wild Things,2011,20000000,29795299,55576699,35576699,1.78,1
2661,The Stepfather,2006,20000000,29062561,29227561,9227561,0.46,0
2662,High Fidelity,2005,20000000,27277055,47881663,27881663,1.39,0
2663,Stick It,2017,20000000,26910736,30399714,10399714,0.52,0
2667,The World's End,2009,20000000,26004851,47508505,27508505,1.38,0
2669,You Again,2008,20000000,25702053,32838945,12838945,0.64,0
2670,Nancy Drew,2015,20000000,25584685,30703845,10703845,0.54,0
2671,Alpha and Omega 3D,2004,20000000,25107267,48958353,28958353,1.45,0
2672,On the Basis of Sex,2007,20000000,24622687,38801294,18801294,0.94,0
2673,Endless Love,2008,20000000,23438250,34718173,14718173,0.74,0
2674,The Covenant,2007,20000000,23364784,38164784,18164784,0.91,0
2677,2 For the Money,2007,20000000,22991379,30491379,10491379,0.52,0
2679,Psycho,2005,20000000,21541218,37226218,17226218,0.86,0
2680,Quigley Down Under,2006,20000000,21413105,21413105,1413105,0.07,0
2681,To Die For,2018,20000000,21284514,27688744,7688744,0.38,0
2682,Shorts,2012,20000000,20919166,29870801,9870801,0.49,0
2684,Appaloosa,2017,20000000,20211394,27911453,7911453,0.4,0
2685,Secret in Their Eyes,2009,20000000,20180155,32608019,12608019,0.63,0
2686,Yu-Gi-Oh,2004,20000000,19762690,28762690,8762690,0.44,0
2687,Reign Over Me,2002,20000000,19661987,20081987,81987,0.0,0
2688,My Best Friend's Girl,2017,20000000,19219250,34787111,14787111,0.74,0
2689,Georgia Rule,2007,20000000,18882880,20819601,819601,0.04,0
2690,Under the Rainbow,2003,20000000,18826490,18826490,-1173510,-0.06,0
2691,Ladyhawke,2009,20000000,18400000,18400000,-1600000,-0.08,0
2692,Into the Wild,2007,20000000,18354356,56822960,36822960,1.84,1
2693,Simon Birch,2004,20000000,18253415,18310591,-1689409,-0.08,0
2694,Pooh's Heffalump Movie,2003,20000000,18098433,55686944,35686944,1.78,1
2696,Operation Finale,2000,20000000,17612099,17612099,-2387901,-0.12,0
2698,Home for the Holidays,2009,20000000,17468887,22119269,2119269,0.11,0
2699,The Zookeeperâs Wife,2012,20000000,17445186,26308749,6308749,0.32,0
2700,Fired Up,2008,20000000,17231291,18608570,-1391430,-0.07,0
2701,Kung Fu Hustle,2011,20000000,17104669,102034104,82034104,4.1,1
2703,Flatliners,2009,20000000,16883115,45173738,25173738,1.26,0
2704,Dead Silence,2015,20000000,16574590,20614661,614661,0.03,0
2705,21 Grams,2004,20000000,16248701,59667625,39667625,1.98,1
2706,Armored,2006,20000000,15988876,23661038,3661038,0.18,0
2708,Paparazzi,2008,20000000,15712072,16612072,-3387928,-0.17,0
2709,A Guy Thing,2002,20000000,15543862,17430594,-2569406,-0.13,0
2710,The Greatest Story Ever Told,2016,20000000,15473333,15473333,-4526667,-0.23,0
2711,Loser,2016,20000000,15464026,18250106,-1749894,-0.09,0
2712,Twilight,2005,20000000,15055091,15055091,-4944909,-0.25,0
2713,Capitalism: A Love Story,2002,20000000,14363397,19121531,-878469,-0.04,0
2714,Lockout,2009,20000000,14326865,33943049,13943049,0.7,0
2715,Disaster Movie,2010,20000000,14190901,36720752,16720752,0.84,0
2717,The Man Who Knew Too Little,2008,20000000,13801755,13801755,-6198245,-0.31,0
2718,Crank 2: High Voltage,2005,20000000,13684249,35472739,15472739,0.77,0
2723,Ghost Town,2007,20000000,13367624,29958228,9958228,0.5,0
2724,The Quiet American,2016,20000000,12987647,26348203,6348203,0.32,0
2725,Triple 9,2017,20000000,12639297,25943792,5943792,0.3,0
2726,The Light Between Oceans,2009,20000000,12545979,22281732,2281732,0.11,0
2727,The Weather Man,2019,20000000,12482775,15466961,-4533039,-0.23,0
2728,Undisputed,2004,20000000,12398628,12398628,-7601372,-0.38,0
2729,12 Rounds,2013,20000000,12234694,17306648,-2693352,-0.13,0
2730,Let Me In,2016,20000000,12134935,28270399,8270399,0.41,0
2731,3 Ninjas Kick Back,2007,20000000,11744960,11744960,-8255040,-0.41,0
2732,Be Kind Rewind,2005,20000000,11175164,30894247,10894247,0.54,0
2733,Mrs. Henderson Presents,2007,20000000,11036366,27836366,7836366,0.39,0
2734,Deconstructing Harry,2014,20000000,10686841,10686841,-9313159,-0.47,0
2735,Three to Tango,2004,20000000,10570375,10570375,-9429625,-0.47,0
2736,We're No Angels,2013,20000000,10555348,10555348,-9444652,-0.47,0
2738,Death Sentence,2006,20000000,9534258,16907831,-3092169,-0.15,0
2739,Popstar: Never Stop Never Stopping,2005,20000000,9496130,9537120,-10462880,-0.52,0
2740,Thank You for Your Service,2008,20000000,9479390,9985316,-10014684,-0.5,0
2741,Everybody's Fine,2003,20000000,9208876,9208876,-10791124,-0.54,0
2742,Whereâd You Go Bernadette,2008,20000000,9198356,10078776,-9921224,-0.5,0
2743,Superbabies: Baby Geniuses 2,2015,20000000,9109322,9355369,-10644631,-0.53,0
2745,Ratchet and Clank,2012,20000000,8813410,14365639,-5634361,-0.28,0
2746,Death at a Funeral,2014,20000000,8580428,46285504,26285504,1.31,0
2747,The Man,2011,20000000,8330720,10393696,-9606304,-0.48,0
2748,Code Name: The Cleaner,2006,20000000,8135024,8135024,-11864976,-0.59,0
2749,Inherent Vice,2009,20000000,8110975,14772346,-5227654,-0.26,0
2750,Connie and Carla,2005,20000000,8047525,9609811,-10390189,-0.52,0
2751,Machete Kills,2004,20000000,8008161,18273009,-1726991,-0.09,0
2752,Sweet Charity,2016,20000000,8000000,8000000,-12000000,-0.6,0
2753,Doogal,2019,20000000,7578946,28058652,8058652,0.4,0
2754,Proof,2008,20000000,7535331,8284331,-11715669,-0.59,0
2755,An American Carol,2008,20000000,7013191,7022183,-12977817,-0.65,0
2756,Willard,2007,20000000,6882696,6882696,-13117304,-0.66,0
2757,Strange Wilderness,2012,20000000,6575282,6947084,-13052916,-0.65,0
2758,Little Boy,2009,20000000,6485961,17769299,-2230701,-0.11,0
2759,Topsy Turvy,2008,20000000,6201757,6201757,-13798243,-0.69,0
2760,Chasing Mavericks,2020,20000000,6002756,8300821,-11699179,-0.58,0
2761,A Most Violent Year,2018,20000000,5749134,8846875,-11153125,-0.56,0
2762,A Dangerous Method,2017,20000000,5702083,14807531,-5192469,-0.26,0
2764,Bandslam,2004,20000000,5210988,12967829,-7032171,-0.35,0
2765,Alone in the Dark,2015,20000000,5178569,10588079,-9411921,-0.47,0
2768,Tolkien,2003,20000000,4535154,8967531,-11032469,-0.55,0
2771,Iâm Not There,2012,20000000,4017609,12397613,-7602387,-0.38,0
2772,The Cold Light of Day,2008,20000000,3763583,25361206,5361206,0.27,0
2773,The Brothers Bloom,2000,20000000,3531756,5531756,-14468244,-0.72,0
2776,Suspiria,2010,20000000,2483472,7023292,-12976708,-0.65,0
2778,Mononoke-hime,2005,20000000,2374107,150345863,130345863,6.52,1
2779,Bon Voyage,2005,20000000,2353728,8359720,-11640280,-0.58,0
2785,Dylan Dog: Dead of Night,2003,20000000,1186538,6093725,-13906275,-0.7,0
2787,The Children of Huang Shi,2012,20000000,1031872,8221700,-11778300,-0.59,0
2790,JÃ¬yÃ¬ dÃ shÄ«,2015,20000000,587470,43888531,23888531,1.19,0
2793,Steamboy,2014,20000000,468867,10468867,-9531133,-0.48,0
2797,é·æ±ä¸è (CJ7),2017,20000000,206678,47300771,27300771,1.37,0
2799,Les Couloirs du temps: Les visiteurs 2,2006,20000000,146072,26146072,6146072,0.31,0
2800,People I Know,2013,20000000,121972,5694213,-14305787,-0.72,0
2801,Regression,2011,20000000,55039,15824374,-4175626,-0.21,0
2804,Three Kingdoms: Resurrection of the Dragon,2000,20000000,0,22139590,2139590,0.11,0
2805,The Touch,2011,20000000,0,5918742,-14081258,-0.7,0
2814,The Shape of Water,2010,19500000,63859435,195790794,176290794,9.04,1
2815,De rouille et dâos,2009,19500000,2061449,29393634,9893634,0.51,0
2816,The Painted Veil,2018,19400000,8060487,15118795,-4281205,-0.22,0
2817,The Frozen Ground,2010,19200000,0,5617460,-13582540,-0.71,0
2818,The Devil's Double,2010,19100000,1361512,5965646,-13134354,-0.69,0
2819,Back to the Future,2013,19000000,212259762,385524118,366524118,19.29,1
2820,Dances with Wolves,2007,19000000,184208842,424208842,405208842,21.33,1
2821,Scary Movie,2000,19000000,157019771,277200000,258200000,13.59,1
2823,Sausage Party,2012,19000000,97670358,141344255,122344255,6.44,1
2824,Sea of Love,2002,19000000,58571513,58571513,39571513,2.08,1
2825,Just Married,2008,19000000,56127162,101564935,82564935,4.35,1
2827,A Cinderella Story,2011,19000000,51438175,70164105,51164105,2.69,1
2828,The Shining,2012,19000000,44568631,45325009,26325009,1.39,0
2829,Thirteen Ghosts,2018,19000000,41867960,68467960,49467960,2.6,1
2832,Notorious,2011,19000000,36843682,44972183,25972183,1.37,0
2834,The Switch,2016,19000000,27758465,49858465,30858465,1.62,1
2835,Leap Year,2005,19000000,25918920,32618920,13618920,0.72,0
2836,The Book Thief,2006,19000000,21488481,76086711,57086711,3.0,1
2837,"Gone, Baby, Gone",2005,19000000,20300218,34352162,15352162,0.81,0
2838,Thomas and the Magic Railroad,2002,19000000,15911332,15911332,-3088668,-0.16,0
2839,Mutiny on The Bounty,2009,19000000,13680000,13680000,-5320000,-0.28,0
2841,Sen to Chihiro no Kamikakushi,2008,19000000,10049886,273079182,254079182,13.37,1
2842,Sex Drive,2001,19000000,8402485,10412485,-8587515,-0.45,0
2843,Firestorm,2020,19000000,8123860,8123860,-10876140,-0.57,0
2844,Take Me Home Tonight,2014,19000000,6928068,7576604,-11423396,-0.6,0
2845,Won't Back Down,2006,19000000,5310554,5745503,-13254497,-0.7,0
2853,IndigÃ¨nes,2004,18900000,320700,26063572,7163572,0.38,0
2854,The Amityville Horror,2005,18500000,65233369,109175673,90675673,4.9,1
2855,Adaptation,2003,18500000,22498520,32531759,14031759,0.76,0
2857,Fear and Loathing in Las Vegas,2016,18500000,10680275,13711903,-4788097,-0.26,0
2858,Ne le dis Ã  personne,2015,18500000,6198883,33954018,15454018,0.84,0
2860,The Hunt,2011,18200000,5812500,7661379,-10538621,-0.58,0
2862,Borat,2008,18000000,128505958,261443242,243443242,13.52,1
2863,The Mask,2011,18000000,119920129,351620129,333620129,18.53,1
2864,Big,2003,18000000,114968774,151668774,133668774,7.43,1
2865,Legally Blonde,2018,18000000,96493426,141809235,123809235,6.88,1
2866,Mean Girls,2014,18000000,86047227,130724541,112724541,6.26,1
2868,The Exorcism of Emily Rose,2001,18000000,75072454,144529078,126529078,7.03,1
2869,Deuce Bigalow: Male Gigolo,2002,18000000,65535067,92935067,74935067,4.16,1
2870,Barbershop 2: Back in Business,2013,18000000,65070412,65842412,47842412,2.66,1
2871,The Family Stone,2006,18000000,60062868,92357499,74357499,4.13,1
2872,Bad Santa,2003,18000000,60060328,77147031,59147031,3.29,1
2873,Predator,2005,18000000,59735548,98267558,80267558,4.46,1
2875,The Perfect Guy,2015,18000000,57027435,60278166,42278166,2.35,1
2877,Diary of a Wimpy Kid: Rodrick Rules,2019,18000000,52698535,73695194,55695194,3.09,1
2879,Prom Night,2015,18000000,43869350,57193655,39193655,2.18,1
2881,Under the Tuscan Sun,2009,18000000,43601508,57490024,39490024,2.19,1
2883,Birdman or (The Unexpected Virtue of Ignorance),2009,18000000,42340598,103215094,85215094,4.73,1
2884,Peggy Sue Got Married,2009,18000000,41382841,41382841,23382841,1.3,0
2885,Gosford Park,2017,18000000,41300105,41300105,23300105,1.29,0
2887,Blue Jasmine,2010,18000000,33404871,102912961,84912961,4.72,1
2888,United 93,2000,18000000,31567134,77635035,59635035,3.31,1
2889,Honey,2000,18000000,30272254,62646763,44646763,2.48,1
2890,The Fog,2016,18000000,29511112,37048526,19048526,1.06,0
2891,Spy Hard,2004,18000000,26936265,26936265,8936265,0.5,0
2892,Ricki and the Flash,2013,18000000,26839498,41166033,23166033,1.29,0
2893,Glory,2001,18000000,26828365,26828365,8828365,0.49,0
2894,The Art of Racing in the Rain,2010,18000000,26402818,30997027,12997027,0.72,0
2895,Conan the Destroyer,2014,18000000,26400000,26400000,8400000,0.47,0
2896,Love the Coopers,2009,18000000,26302731,44263413,26263413,1.46,0
2898,Observe and Report,2001,18000000,24007324,27148898,9148898,0.51,0
2900,Love Happens,2014,18000000,22965110,36133014,18133014,1.01,0
2901,Fame,2013,18000000,22455510,80227619,62227619,3.46,1
2903,Young Sherlock Holmes,2004,18000000,19739000,19739000,1739000,0.1,0
2906,Center Stage,2010,18000000,17200925,21361109,3361109,0.19,0
2909,Jobs,2008,18000000,16131410,43402515,25402515,1.41,0
2910,Life as a House,2008,18000000,15652637,23889158,5889158,0.33,0
2912,And So It Goes,2010,18000000,15160801,17920013,-79987,-0.0,0
2914,Blow Out,2014,18000000,13747234,13747234,-4252766,-0.24,0
2916,The Legend of the Lone Ranger,2016,18000000,13400000,13400000,-4600000,-0.26,0
2917,Labor Day,2016,18000000,13371528,14189810,-3810190,-0.21,0
2918,Getaway,2013,18000000,10501938,11813989,-6186011,-0.34,0
2919,The Ice Storm,2003,18000000,8038061,16011975,-1988025,-0.11,0
2921,Troop Beverly Hills,2017,18000000,7190505,7190505,-10809495,-0.6,0
2922,Nine 1/2 Weeks,2009,18000000,6734844,6734844,-11265156,-0.63,0
2924,Dragonslayer,2013,18000000,6000000,6000000,-12000000,-0.67,0
2925,Ed Wood,2002,18000000,5828466,5828466,-12171534,-0.68,0
2926,Mongol,2009,18000000,5705761,27147349,9147349,0.51,0
2928,Megaforce,2010,18000000,5675599,5675599,-12324401,-0.68,0
2929,Mao's Last Dancer,2006,18000000,4806750,25941437,7941437,0.44,0
2930,Hamlet,2020,18000000,4501094,7129670,-10870330,-0.6,0
2931,The Railway Man,2016,18000000,4438438,23910210,5910210,0.33,0
2933,Midnight Special,2008,18000000,3712282,7680250,-10319750,-0.57,0
2934,Miss Sloane,2014,18000000,3500605,7719630,-10280370,-0.57,0
2935,Metallica Through the Never,2016,18000000,3419967,9082906,-8917094,-0.5,0
2938,T2: Trainspotting,2012,18000000,2402004,42091262,24091262,1.34,0
2939,Das Weisse Band: Eine deutsche Kindergeschichte,2007,18000000,2222862,25727044,7727044,0.43,0
2954,Red Sonja,2004,17900000,6905861,6908640,-10991360,-0.61,0
2955,Baekdusan,2013,17700000,372562,59505509,41805509,2.36,1
2956,Red Lights,2009,17700000,49521,14518884,-3181116,-0.18,0
2957,Superbad,2012,17500000,121463226,169955142,152455142,8.71,1
2959,Step Up 2 the Streets,2013,17500000,58017783,148586910,131086910,7.49,1
2960,Hoodwinked,2004,17500000,51386611,109843390,92343390,5.28,1
2961,Hotel Rwanda,2010,17500000,23519128,36521223,19021223,1.09,0
2962,Beerfest,2015,17500000,19185184,20159316,2659316,0.15,0
2963,Black Nativity,2019,17500000,7018188,7454184,-10045816,-0.57,0
2966,Hotel Mumbai,2019,17300000,9619500,21132855,3832855,0.22,0
2967,A Quiet Place,2002,17000000,188024361,336151692,319151692,18.77,1
2968,The Others,2003,17000000,96522687,207765056,190765056,11.22,1
2969,Aliens,2007,17000000,85160248,183316455,166316455,9.78,1
2971,I Know What You Did Last Summer,2011,17000000,72250091,125250091,108250091,6.37,1
2972,My Fair Lady,2010,17000000,72000000,72071636,55071636,3.24,1
2974,The Best Man Holiday,2010,17000000,70525195,72835710,55835710,3.28,1
2975,Friday the 13th,2003,17000000,65002019,92670237,75670237,4.45,1
2976,Pitch Perfect,2006,17000000,65001093,116044347,99044347,5.83,1
2977,Halloween: H2O,2001,17000000,55041738,55041738,38041738,2.24,1
2979,Jet Li's Hero,2006,17000000,53652140,177535958,160535958,9.44,1
2981,"McFarland, USA",2002,17000000,44480275,45707924,28707924,1.69,1
2984,The Hills Have Eyes,2009,17000000,41778863,70355813,53355813,3.14,1
2985,Crawl,2006,17000000,39014193,90008356,73008356,4.29,1
2986,40 Days and 40 Nights,2008,17000000,37939782,95092667,78092667,4.59,1
2987,Good Boy!,2006,17000000,37667746,45312217,28312217,1.67,1
2988,Smokin' Aces,2012,17000000,35662731,57263440,40263440,2.37,1
2989,A Night at the Roxbury,2004,17000000,30331165,30331165,13331165,0.78,0
2991,Brooklyn's Finest,2010,17000000,27163593,39233233,22233233,1.31,0
2993,Lottery Ticket,2003,17000000,24719879,24719879,7719879,0.45,0
2994,Dickie Roberts: Former Child Star,2016,17000000,22734486,23734486,6734486,0.4,0
2995,ATL,2019,17000000,21170563,21170563,4170563,0.25,0
2996,Summer Catch,2007,17000000,19693891,19693891,2693891,0.16,0
2997,A Simple Plan,2015,17000000,16316273,16316273,-683727,-0.04,0
2998,Larry the Cable Guy: Health Inspector,2015,17000000,15680099,15680099,-1319901,-0.08,0
2999,Superman IV: The Quest for Peace,2009,17000000,14522355,36700000,19700000,1.16,0
3001,The Adventures of Elmo in Grouchland,2020,17000000,11634458,11634458,-5365542,-0.32,0
3002,55 Days at Peking,2016,17000000,10000000,10000000,-7000000,-0.41,0
3003,My Life in Ruins,2006,17000000,8677425,20477425,3477425,0.2,0
3007,The Apparition,2006,17000000,4936819,10637281,-6362719,-0.37,0
3010,L'illusionniste,2007,17000000,2231474,8609949,-8390051,-0.49,0
3013,Genius,2017,17000000,1361045,7265283,-9734717,-0.57,0
3021,The Young Messiah,2009,16800000,6469813,7313697,-9486303,-0.56,0
3023,My Girl,2006,16500000,58011485,58011485,41511485,2.52,1
3024,Wall Street,2006,16500000,43848100,43848100,27348100,1.66,1
3025,Sense and Sensibility,2011,16500000,42993774,134993774,118493774,7.18,1
3026,The Illusionist,2007,16500000,39868642,83792062,67292062,4.08,1
3028,House of Sand and Fog,2001,16500000,13005485,16157923,-342077,-0.02,0
3031,Le Flic de Belleville,2001,16500000,0,8126380,-8373620,-0.51,0
3032,Dead Poets Society,2008,16400000,95860116,239500000,223100000,13.6,1
3034,Dumb &amp; Dumber,2008,16000000,127175374,246400000,230400000,14.4,1
3035,When Harry Met Sallyâ¦,2019,16000000,92823546,92961960,76961960,4.81,1
3036,Road Trip,2019,16000000,68525609,119739110,103739110,6.48,1
3037,The Verdict,2000,16000000,53977250,53977250,37977250,2.37,1
3038,Varsity Blues,2018,16000000,52894169,54294169,38294169,2.39,1
3040,The Artist,2010,16000000,44667095,128256712,112256712,7.02,1
3041,The Unborn,2002,16000000,42670410,78208812,62208812,3.89,1
3042,The Master of Disguise,2009,16000000,40363530,40363530,24363530,1.52,1
3043,The Texas Chainsaw Massacre: The Beginning,2000,16000000,39517763,50517763,34517763,2.16,1
3045,The Roommate,2003,16000000,37300107,52545707,36545707,2.28,1
3046,The Messengers,2014,16000000,35374833,53774833,37774833,2.36,1
3047,The Killing Fields,2004,16000000,34609720,34609720,18609720,1.16,0
3049,Double Impact,2012,16000000,29090445,29090445,13090445,0.82,0
3051,Joe Dirt,2004,16000000,27087695,30987695,14987695,0.94,0
3054,Vicky Cristina Barcelona,2016,16000000,23216709,104504817,88504817,5.53,1
3055,A Dogâs Journey,2002,16000000,22782371,78099156,62099156,3.88,1
3056,Stuber,2000,16000000,22370452,29634769,13634769,0.85,0
3058,Superfly,2007,16000000,20537137,20723581,4723581,0.3,0
3059,LÃ©on,2014,16000000,19284974,45284974,29284974,1.83,1
3060,Remember Me,2013,16000000,19068240,56506120,40506120,2.53,1
3061,White Oleander,2014,16000000,16357770,21657770,5657770,0.35,0
3063,Drowning Mona,2005,16000000,15427192,15980376,-19624,-0.0,0
3064,Radio Days,2008,16000000,14792779,14792779,-1207221,-0.08,0
3065,How to Deal,2014,16000000,14108518,14125516,-1874484,-0.12,0
3066,Left Behind,2019,16000000,14019924,20769209,4769209,0.3,0
3067,Soul Plane,2010,16000000,13922211,14553807,-1446193,-0.09,0
3068,My Stepmother Is an Alien,2008,16000000,13854000,13854000,-2146000,-0.13,0
3069,People Like Us,2012,16000000,12431792,12617472,-3382528,-0.21,0
3070,The Thirteenth Floor,2010,16000000,11810854,11810854,-4189146,-0.26,0
3071,The Cookout,2010,16000000,11540112,11540112,-4459888,-0.28,0
3072,Meteor,2013,16000000,8400000,8400000,-7600000,-0.48,0
3073,Highlander,2020,16000000,5900000,12900000,-3100000,-0.19,0
3074,Bleed for This,2018,16000000,5083906,7171320,-8828680,-0.55,0
3075,Hollywood Ending,2018,16000000,4839383,14839383,-1160617,-0.07,0
3076,Duets,2002,16000000,4734235,6615452,-9384548,-0.59,0
3077,Detroit Rock City,2020,16000000,4217115,5825314,-10174686,-0.64,0
3078,Things We Lost in the Fire,2007,16000000,3287315,8120148,-7879852,-0.49,0
3079,The Homesman,2002,16000000,2429989,8217571,-7782429,-0.49,0
3080,Trance,2007,16000000,2322593,22594052,6594052,0.41,0
3081,The Immigrant,2005,16000000,2013456,7585011,-8414989,-0.53,0
3084,Bienvenue chez les Ch'tis,2002,16000000,1477650,247474497,231474497,14.47,1
3091,Hachiko: A Dog's Story,2010,16000000,0,47707417,31707417,1.98,1
3096,Juwanna Mann,2017,15600000,13571817,13771817,-1828183,-0.12,0
3097,The Personal History of David Copperfield,2013,15600000,0,8112805,-7487195,-0.48,0
3103,Far from the Madding Crowd,2016,15495600,12236500,29729450,14233850,0.92,0
3104,Wasabi,2013,15300000,81525,7000000,-8300000,-0.54,0
3108,Top Gun,2010,15000000,179800601,356799634,341799634,22.79,1
3110,3 Men and a Baby,2007,15000000,167780960,167780960,152780960,10.19,1
3111,The Kingâs Speech,2006,15000000,138797449,430821168,415821168,27.72,1
3112,American Beauty,2007,15000000,130058047,356258047,341258047,22.75,1
3113,"Crouching Tiger, Hidden Dragon",2012,15000000,128067808,213514672,198514672,13.23,1
3116,Annabelle: Creation,2018,15000000,102092201,305384865,290384865,19.36,1
3117,Jackass Presents: Bad Grandpa,2006,15000000,102003019,160903019,145903019,9.73,1
3118,Heaven Can Wait,2002,15000000,98800000,98800000,83800000,5.59,1
3121,Beetlejuice,2013,15000000,73839613,73887546,58887546,3.93,1
3122,Ben-Hur,2003,15000000,73000000,73259017,58259017,3.88,1
3123,10 Cloverfield Lane,2015,15000000,72082999,108286422,93286422,6.22,1
3124,Mama,2012,15000000,71628180,148095566,133095566,8.87,1
3127,Lethal Weapon,2001,15000000,65192350,120192350,105192350,7.01,1
3128,Diary of a Wimpy Kid,2014,15000000,64003625,76954311,61954311,4.13,1
3130,Halloween,2014,15000000,58269151,77514401,62514401,4.17,1
3131,The Queen,2011,15000000,56441711,128885873,113885873,7.59,1
3132,Why Did I Get Married?,2000,15000000,55204525,55934178,40934178,2.73,1
3134,Little Women,2018,15000000,50003303,50003303,35003303,2.33,1
3135,The Deer Hunter,2003,15000000,50000000,50057660,35057660,2.34,1
3136,BlacKkKlansman,2009,15000000,49275340,93411426,78411426,5.23,1
3137,When a Stranger Calls,2000,15000000,47860214,67215435,52215435,3.48,1
3138,Big Fat Liar,2009,15000000,47811275,52461017,37461017,2.5,1
3139,Cop Land,2009,15000000,44906632,63706632,48706632,3.25,1
3140,Wag the Dog,2005,15000000,43057470,64252038,49252038,3.28,1
3141,Snitch,2005,15000000,42930462,57907734,42907734,2.86,1
3143,Krampus,2002,15000000,42725475,61788393,46788393,3.12,1
3144,End of Watch,2007,15000000,41003371,57586606,42586606,2.84,1
3145,The Faculty,2014,15000000,40283321,40283321,25283321,1.69,1
3147,Not Another Teen Movie,2004,15000000,37882551,62401343,47401343,3.16,1
3149,Lawrence of Arabia,2007,15000000,37495385,69995385,54995385,3.67,1
3151,Drive,2000,15000000,35060689,81357930,66357930,4.42,1
3152,The Skulls,2017,15000000,35007180,35007180,20007180,1.33,0
3153,Hawaii,2000,15000000,34562222,34562222,19562222,1.3,0
3155,Malibu's Most Wanted,2010,15000000,34308901,34499204,19499204,1.3,0
3156,All About Steve,2014,15000000,33862903,40127259,25127259,1.68,1
3158,Halloween 2,2005,15000000,33392973,38512850,23512850,1.57,1
3161,The Wedding Date,2000,15000000,31726995,47175038,32175038,2.15,1
3162,The Princess Bride,2013,15000000,30857000,30882822,15882822,1.06,0
3163,Halloween: Resurrection,2006,15000000,30259652,37659652,22659652,1.51,1
3164,The Great Debaters,2007,15000000,30226144,30261293,15261293,1.02,0
3165,When the Game Stands Tall,2016,15000000,30127963,30138912,15138912,1.01,0
3166,Clash of the Titans,2020,15000000,30000000,44400000,29400000,1.96,1
3167,Confessions of a Teenage Drama Queen,2010,15000000,29331068,33118854,18118854,1.21,0
3168,The Object of my Affection,2002,15000000,29145924,29145924,14145924,0.94,0
3169,28 Weeks Later,2006,15000000,28638916,64232714,49232714,3.28,1
3172,Home Again,2014,15000000,27020284,37336874,22336874,1.49,0
3173,Book of Shadows: Blair Witch 2,2009,15000000,26421314,47721314,32721314,2.18,1
3174,Boogie Nights,2000,15000000,26410771,43111725,28111725,1.87,1
3175,Ramona and Beezus,2012,15000000,26167002,27469621,12469621,0.83,0
3177,The Craft,2019,15000000,24769466,55669466,40669466,2.71,1
3178,Match Point,2012,15000000,23089926,87973835,72973835,4.86,1
3179,The Remains of the Day,2001,15000000,22954968,63954968,48954968,3.26,1
3180,Nowhere to Run,2011,15000000,22189039,52189039,37189039,2.48,1
3181,Urban Legends: Final Cut,2004,15000000,21468807,38574362,23574362,1.57,1
3182,The Place Beyond the Pines,2009,15000000,21403519,47011449,32011449,2.13,1
3183,Flicka,2008,15000000,21000147,21896367,6896367,0.46,0
3184,The Hills Have Eyes II,2008,15000000,20804166,37466538,22466538,1.5,1
3185,Keanu,2000,15000000,20591853,20688141,5688141,0.38,0
3186,The Photograph,2016,15000000,20578185,20666669,5666669,0.38,0
3187,Country Strong,2006,15000000,20218921,20601987,5601987,0.37,0
3188,Tuck Everlasting,2003,15000000,19161999,19344615,4344615,0.29,0
3189,The Marine,2019,15000000,18844784,22165608,7165608,0.48,0
3190,Disturbing Behavior,2002,15000000,17507368,19014238,4014238,0.27,0
3195,The Man with the Iron Fists,2000,15000000,15634090,22018988,7018988,0.47,0
3196,Firestarter,2004,15000000,15136870,15136870,136870,0.01,0
3199,Freddy Got Fingered,2007,15000000,14249005,14249005,-750995,-0.05,0
3200,One Day,2003,15000000,13843771,59168692,44168692,2.94,1
3201,De-Lovely,2007,15000000,13337299,18524496,3524496,0.23,0
3203,The Pirates Who Don't Do Anything: A VeggieTale…,2016,15000000,12981269,13248444,-1751556,-0.12,0
3204,U2 3D,2000,15000000,12898847,26170402,11170402,0.74,0
3205,Highlander: Endgame,2003,15000000,12801190,12801190,-2198810,-0.15,0
3206,The Founder,2002,15000000,12786053,24403192,9403192,0.63,0
3208,Confidence,2006,15000000,12212417,12970401,-2029599,-0.14,0
3209,Blinded by the Light,2015,15000000,11901145,18067151,3067151,0.2,0
3210,Knockaround Guys,2008,15000000,11660180,12419700,-2580300,-0.17,0
3211,The Muse,2013,15000000,11614954,11614954,-3385046,-0.23,0
3212,Barney's Great Adventure,2001,15000000,11156471,11156471,-3843529,-0.26,0
3213,New York Stories,2018,15000000,10763469,10763469,-4236531,-0.28,0
3214,Home Fries,2008,15000000,10513979,10513979,-4486021,-0.3,0
3215,Here on Earth,2009,15000000,10494147,10845127,-4154873,-0.28,0
3216,Raise Your Voice,2009,15000000,10411980,14811980,-188020,-0.01,0
3217,Brazil,2000,15000000,9929135,9932146,-5067854,-0.34,0
3218,The Dark Half,2005,15000000,9579068,9579068,-5420932,-0.36,0
3220,Dark Blue,2007,15000000,9237470,12262065,-2737935,-0.18,0
3221,A Mighty Heart,2005,15000000,9176787,19153568,4153568,0.28,0
3223,Queen of Katwe,2015,15000000,8874389,10055481,-4944519,-0.33,0
3224,Whatever it Takes,2007,15000000,8735529,8735529,-6264471,-0.42,0
3225,Boat Trip,2010,15000000,8586376,14933713,-66287,-0.0,0
3226,The Importance of Being Earnest,2015,15000000,8378141,8667209,-6332791,-0.42,0
3227,The Love Letter,2010,15000000,8322608,9059170,-5940830,-0.4,0
3228,Hoot,2016,15000000,8117637,8224998,-6775002,-0.45,0
3229,Trumbo,2003,15000000,7857741,13300181,-1699819,-0.11,0
3230,In Bruges,2008,15000000,7800825,34533783,19533783,1.3,0
3233,Hotel Artemis,2017,15000000,6708137,13316627,-1683373,-0.11,0
3234,The Rocker,2008,15000000,6409528,8767338,-6232662,-0.42,0
3235,Post Grad,2006,15000000,6382178,6563402,-8436598,-0.56,0
3238,Los tres entierros de Melquiades Estrada,2015,15000000,5027684,13454474,-1545526,-0.1,0
3240,Se jie,2013,15000000,4604982,65167430,50167430,3.34,1
3241,"Kiss Kiss, Bang Bang",2004,15000000,4235837,16829464,1829464,0.12,0
3243,Scouts Guide to the Zombie Apocalypse,2003,15000000,3703046,15554855,554855,0.04,0
3244,Blood and Chocolate,2010,15000000,3526588,6551310,-8448690,-0.56,0
3245,You Will Meet a Tall Dark Stranger,2009,15000000,3247816,38535748,23535748,1.57,1
3247,Never Let Me Go,2008,15000000,2434652,11173718,-3826282,-0.26,0
3250,Transsiberian,2002,15000000,2203641,6379575,-8620425,-0.57,0
3254,Funny Games,2014,15000000,1294640,8200127,-6799873,-0.45,0
3255,Banlieue 13,2015,15000000,1200216,11599903,-3400097,-0.23,0
3258,CÃ¬kÃ¨ NiÃ¨ YinniÃ¡ng,2005,15000000,632542,11279884,-3720116,-0.25,0
3261,The Return,2001,15000000,501752,5953886,-9046114,-0.6,0
3265,Ong-Bak 2,2011,15000000,102458,7583050,-7416950,-0.49,0
3284,Groundhog Day,2012,14600000,70906973,70906973,56306973,3.86,1
3287,Elle s'appelait Sarah,2019,14500000,7691700,25480031,10980031,0.76,0
3289,Unforgiven,2012,14400000,101157447,159157447,144757447,10.05,1
3291,Pretty Woman,2002,14000000,178406268,432645872,418645872,29.9,1
3292,Fatal Attraction,2002,14000000,156645693,320100000,306100000,21.86,1
3294,Towering Inferno,2010,14000000,116000000,139700000,125700000,8.98,1
3296,Born on the Fourth of July,2006,14000000,70001698,70001698,56001698,4.0,1
3297,Cool Runnings,2003,14000000,68856263,155008909,141008909,10.07,1
3298,Stomp the Yard,2009,14000000,61356221,75525718,61525718,4.39,1
3303,Breakthrough,2002,14000000,40713082,49022827,35022827,2.5,1
3305,Taps,2007,14000000,35856053,35856053,21856053,1.56,1
3306,Tyler Perry's Good Deeds,2015,14000000,35025791,35579177,21579177,1.54,1
3307,White Fang,2019,14000000,34729091,34729091,20729091,1.48,0
3308,Dangerous Liaisons,2006,14000000,34700000,34700000,20700000,1.48,0
3309,Jojo Rabbit,2001,14000000,33370906,87166699,73166699,5.23,1
3310,Superstar,2012,14000000,30628981,30628981,16628981,1.19,0
3312,Poetic Justice,2007,14000000,27450453,27450453,13450453,0.96,0
3313,Jonah: A VeggieTales Movie,2006,14000000,25571351,25608779,11608779,0.83,0
3314,All About the Benjamins,2000,14000000,25482931,25873145,11873145,0.85,0
3316,Our Family Wedding,2014,14000000,20255281,21410546,7410546,0.53,0
3317,Vampire in Brooklyn,2006,14000000,19637147,19637147,5637147,0.4,0
3318,An American Haunting,2014,14000000,16298046,30443277,16443277,1.17,0
3319,My Boss's Daughter,2001,14000000,15549702,15565357,1565357,0.11,0
3320,A Perfect Getaway,2009,14000000,15515460,22815460,8815460,0.63,0
3322,Dead Man on Campus,2010,14000000,15064948,15064948,1064948,0.08,0
3324,"New York, New York",2010,14000000,13800000,13800000,-200000,-0.01,0
3325,Jason X,2003,14000000,13121555,16951798,2951798,0.21,0
3326,Crooklyn,2008,14000000,13024170,13024170,-975830,-0.07,0
3327,I Think I Love My Wife,2011,14000000,12559771,13205411,-794589,-0.06,0
3328,Hot Tub Time Machine 2,2012,14000000,12314651,12826644,-1173356,-0.08,0
3329,After,2009,14000000,12138565,58090525,44090525,3.15,1
3330,Bobby,2005,14000000,11242801,20597806,6597806,0.47,0
3334,Le Scaphandre et le Papillon,2018,14000000,5990075,22754472,8754472,0.63,0
3335,Little Children,2002,14000000,5463019,14121177,121177,0.01,0
3336,Gossip,2012,14000000,5108820,12591270,-1408730,-0.1,0
3339,Catch a Fire,2005,14000000,4299773,5782198,-8217802,-0.59,0
3340,Mr. Turner,2001,14000000,3958546,25187026,11187026,0.8,0
3342,Easy Virtue,2014,14000000,2656784,20537741,6537741,0.47,0
3350,Reign of Assassins,2016,14000000,0,11354230,-2645770,-0.19,0
3352,Brokeback Mountain,2004,13900000,83043761,176980863,163080863,11.73,1
3357,Super Troopers 2,2007,13500000,30617396,31575635,18075635,1.34,0
3358,Far From Heaven,2014,13500000,15901849,29027914,15527914,1.15,0
3359,Seven Psychopaths,2000,13500000,15024049,33035736,19535736,1.45,0
3361,The Border,2014,13500000,6118683,6118683,-7381317,-0.55,0
3362,Der Untergang,2014,13500000,5501940,93631744,80131744,5.94,1
3370,Save the Last Dance,2013,13000000,91038276,122244329,109244329,8.4,1
3371,Justin Bieber: Never Say Never,2007,13000000,73013910,99034125,86034125,6.62,1
3372,The First Purge,2015,13000000,69488745,137054597,124054597,9.54,1
3374,Snow Day,2001,13000000,60008303,62452927,49452927,3.8,1
3375,The Butterfly Effect,2016,13000000,57924679,95638592,82638592,6.36,1
3376,The Godfather: Part II,2013,13000000,57300000,57300000,44300000,3.41,1
3377,The Shallows,2012,13000000,55121623,118763442,105763442,8.14,1
3378,RoboCop,2001,13000000,53424681,53424681,40424681,3.11,1
3380,This Christmas,2015,13000000,49121934,49733545,36733545,2.83,1
3381,About Last Night,2015,13000000,48637684,50445860,37445860,2.88,1
3382,"Dude, Where's My Car?",2006,13000000,46729374,73180297,60180297,4.63,1
3383,Young Guns,2009,13000000,44726644,44726644,31726644,2.44,1
3384,St. Vincent,2007,13000000,44137712,54837234,41837234,3.22,1
3386,10 Things I Hate About You,2015,13000000,38177966,60413950,47413950,3.65,1
3388,Loaded Weapon 1,2016,13000000,27979399,27979399,14979399,1.15,0
3392,Harriet the Spy,2001,13000000,26570048,26570048,13570048,1.04,0
3393,21 and Over,2002,13000000,25682380,42195766,29195766,2.25,1
3394,The Mist,2007,13000000,25593755,57189408,44189408,3.4,1
3395,Ex Machina,2018,13000000,25440971,38358392,25358392,1.95,1
3396,Being John Malkovich,2007,13000000,22858926,32382381,19382381,1.49,0
3397,Two Can Play That Game,2010,13000000,22235901,22391450,9391450,0.72,0
3398,Eye in the Sky,2001,13000000,18704596,35402802,22402802,1.72,1
3399,Admission,2015,13000000,18007317,18733666,5733666,0.44,0
3401,crazy/beautiful,2010,13000000,16929123,19929123,6929123,0.53,0
3402,54,2010,13000000,16757163,16757163,3757163,0.29,0
3403,Room,2015,13000000,14677674,36262783,23262783,1.79,1
3404,Woodlawn,2006,13000000,14394097,14403703,1403703,0.11,0
3406,MÃ¤n som hatar kvinnor,2006,13000000,12749992,109421911,96421911,7.42,1
3407,The Astronaut Farmer,2011,13000000,11003643,11141213,-1858787,-0.14,0
3408,Dirty Work,2015,13000000,10020081,10020081,-2979919,-0.23,0
3409,Bajrangi Bhaijaan,2000,13000000,8178001,121778347,108778347,8.37,1
3410,Woo,2018,13000000,8064972,8064972,-4935028,-0.38,0
3411,Robinson Crusoe,2011,13000000,8005586,42446455,29446455,2.27,1
3412,Serial Mom,2010,13000000,7881335,7881335,-5118665,-0.39,0
3413,Dick,2018,13000000,6276869,6276869,-6723131,-0.52,0
3414,Light It Up,2012,13000000,5871603,5871603,-7128397,-0.55,0
3416,Birthday Girl,2016,13000000,4919896,8130727,-4869273,-0.37,0
3418,Ben is Back,2002,13000000,3703182,9633387,-3366613,-0.26,0
3420,Chloe,2002,13000000,3075255,11831131,-1168869,-0.09,0
3422,Youth,2002,13000000,2703296,24001573,11001573,0.85,0
3424,Un ProphÃ¨te,2009,13000000,2087720,19910624,6910624,0.53,0
3426,The Vatican Tapes,2008,13000000,1784763,14929184,1929184,0.15,0
3430,Attack the Block,2007,13000000,1024175,6459183,-6540817,-0.5,0
3431,Brothers,2010,13000000,656688,17856688,4856688,0.37,0
3439,The Call,2012,12800000,51872378,69821476,57021476,4.45,1
3440,Operation Chromite,2012,12700000,1022720,49196532,36496532,2.87,1
3441,The Drop,2016,12600000,10724389,19054534,6454534,0.51,0
3442,The Crocodile Hunter: Collision Course,2014,12500000,28436931,33436931,20936931,1.67,1
3446,The Emperor's Club,2014,12500000,14060950,16193713,3693713,0.3,0
3448,Sorority Row,2012,12500000,11965282,26735797,14235797,1.14,0
3449,Glengarry Glen Ross,2014,12500000,10725228,10725228,-1774772,-0.14,0
3452,The Prisoner of Zenda,2002,12500000,7000000,7000000,-5500000,-0.44,0
3463,Ernest et Celestine,2016,12500000,292562,9376444,-3123556,-0.25,0
3467,The Land Before Time,2008,12300000,48092846,81972846,69672846,5.66,1
3468,Jaws,2013,12000000,260000000,470700000,458700000,38.22,1
3470,The Fault in Our Stars,2002,12000000,124872350,307166834,295166834,24.6,1
3471,American Pie,2015,12000000,101800948,234723148,222723148,18.56,1
3472,Think Like a Man,2008,12000000,91547205,113373764,101373764,8.45,1
3473,Heaven is for Real,2002,12000000,91386097,100916299,88916299,7.41,1
3474,The Golden Child,2008,12000000,79817937,79817937,67817937,5.65,1
3475,Star Trek II: The Wrath of Khan,2004,12000000,78912963,95800000,83800000,6.98,1
3476,Barbershop,2001,12000000,75781642,77063461,65063461,5.42,1
3478,Ace Ventura: Pet Detective,2006,12000000,72217396,107217396,95217396,7.93,1
3480,Witness,2016,12000000,65532576,65532576,53532576,4.46,1
3481,Step Up,2002,12000000,65328121,110989157,98989157,8.25,1
3482,Chronicle,2012,12000000,64575175,123681790,111681790,9.31,1
3483,Beavis and Butt-Head Do America,2014,12000000,63118386,63118386,51118386,4.26,1
3487,Lion,2015,12000000,51739495,149570720,137570720,11.46,1
3488,Overboard,2019,12000000,50316123,85369830,73369830,6.11,1
3489,Jackie Brown,2019,12000000,39673162,74727492,62727492,5.23,1
3490,Yentl,2010,12000000,39012241,39012241,27012241,2.25,1
3494,Crossroads,2005,12000000,37188667,57000000,45000000,3.75,1
3495,Paper Towns,2006,12000000,32000304,85450484,73450484,6.12,1
3496,Quarantine,2013,12000000,31691811,41924774,29924774,2.49,1
3497,One Hour Photo,2004,12000000,31597131,52223306,40223306,3.35,1
3498,The Eye,2001,12000000,31418697,57577765,45577765,3.8,1
3499,Johnson Family Vacation,2011,12000000,31203964,31286759,19286759,1.61,1
3500,How High,2020,12000000,31155435,31222395,19222395,1.6,1
3501,Spartacus,2013,12000000,30000000,60000000,48000000,4.0,1
3502,Crank,2018,12000000,27838408,43924923,31924923,2.66,1
3503,The Muppet Christmas Carol,2017,12000000,27281507,27722446,15722446,1.31,0
3506,Katy Perry: Part of Me,2008,12000000,25326071,32700439,20700439,1.73,1
3508,Rounders,2003,12000000,22921898,22921898,10921898,0.91,0
3510,Prophecy,2016,12000000,22673340,22673340,10673340,0.89,0
3511,Project Almanac,2004,12000000,22348241,32909437,20909437,1.74,1
3512,47 Meters Down: Uncaged,2002,12000000,22260900,37565233,25565233,2.13,1
3513,Black and Blue,2017,12000000,22012729,22679978,10679978,0.89,0
3514,Just Wright,2008,12000000,21540363,21867665,9867665,0.82,0
3515,Stir of Echoes,2012,12000000,21133087,23059379,11059379,0.92,0
3517,The Boys from Brazil,2000,12000000,19000000,19000000,7000000,0.58,0
3518,The Upside of Anger,2006,12000000,18761993,28915761,16915761,1.41,0
3520,Nebraska,2012,12000000,17654912,24761360,12761360,1.06,0
3521,My Baby's Daddy,2006,12000000,17321573,17322212,5322212,0.44,0
3523,Young Adult,2003,12000000,16311571,22750356,10750356,0.9,0
3526,If Beale Street Could Talk,2003,12000000,14915773,19859167,7859167,0.65,0
3527,Wish Upon,2008,12000000,14301505,23477345,11477345,0.96,0
3528,Def Jam's How To Be a Player,2009,12000000,14010363,14010363,2010363,0.17,0
3529,Living Out Loud,2013,12000000,12905901,12905901,905901,0.08,0
3530,Rachel Getting Married,2002,12000000,12796861,17475475,5475475,0.46,0
3531,The Postman Always Rings Twice,2007,12000000,12200000,44200000,32200000,2.68,1
3534,Unforgettable,2002,12000000,11368012,16221211,4221211,0.35,0
3535,House of Flying Daggers,2013,12000000,11050094,92863945,80863945,6.74,1
3536,Sorority Boys,2008,12000000,10198766,12516222,516222,0.04,0
3537,Marshall,2005,12000000,10051659,10116816,-1883184,-0.16,0
3538,Cadillac Records,2011,12000000,8195551,8942516,-3057484,-0.25,0
3539,Arbitrage,2005,12000000,7919574,35830713,23830713,1.99,1
3540,The Alamo,2012,12000000,7900000,7900000,-4100000,-0.34,0
3541,Screwed,2010,12000000,6982680,6982680,-5017320,-0.42,0
3542,Running With Scissors,2001,12000000,6860000,8706701,-3293299,-0.27,0
3543,Fortress,2002,12000000,6730578,46730578,34730578,2.89,1
3544,For Greater Glory: The True Story of Cristiada,2015,12000000,5669081,10026255,-1973745,-0.16,0
3545,For Your Consideration,2008,12000000,5549923,5549923,-6450077,-0.54,0
3552,Two Lovers,2009,12000000,3149034,16349034,4349034,0.36,0
3553,La grande bellezza,2015,12000000,2883879,29549145,17549145,1.46,0
3555,Gwoemul,2015,12000000,2201923,92618117,80618117,6.72,1
3559,Stoker,2010,12000000,1703125,12034913,34913,0.0,0
3561,2046,2014,12000000,1442338,19287485,7287485,0.61,0
3577,Trash,2010,12000000,17484,6553186,-5446814,-0.45,0
3588,The Dressmaker,2015,11900000,2022115,24041617,12141617,1.02,0
3591,Gisaengchung,2015,11800000,53369745,254737428,242937428,20.59,1
3593,Pet Sematary,2017,11500000,57469179,57469179,45969179,4.0,1
3594,Dirty Grandpa,2009,11500000,35593113,105078449,93578449,8.14,1
3596,St. Trinianâs,2019,11400000,15000,29830239,18430239,1.62,1
3600,Doctor Zhivago,2012,11000000,111897830,112036323,101036323,9.19,1
3601,The Fighter,2001,11000000,93617009,129262388,118262388,10.75,1
3602,High School Musical 3: Senior Year,2000,11000000,90559416,274392880,263392880,23.94,1
3603,Fried Green Tomatoes,2001,11000000,81204830,81204830,70204830,6.38,1
3604,Jackass: Number Two,2013,11000000,72778712,85278712,74278712,6.75,1
3605,My Cousin Vinny,2002,11000000,52929168,52929168,41929168,3.81,1
3607,Major League,2004,11000000,49793054,49793054,38793054,3.53,1
3608,Phone Booth,2013,11000000,46566212,97837138,86837138,7.89,1
3610,Dead Man Walking,2018,11000000,39387284,83088295,72088295,6.55,1
3611,Cruel Intentions,2016,11000000,38665260,76238901,65238901,5.93,1
3612,Brooklyn,2002,11000000,38322743,62076141,51076141,4.64,1
3613,The Secret Life of Bees,2003,11000000,37780486,39994347,28994347,2.64,1
3614,Wind River,2004,11000000,33800859,44998252,33998252,3.09,1
3615,Woman in Gold,2011,11000000,33307793,58586407,47586407,4.33,1
3616,History of the World: Part I,2003,11000000,31672000,31672000,20672000,1.88,1
3621,Raising Cain,2016,11000000,21171695,21171695,10171695,0.92,0
3622,F.I.S.T,2007,11000000,20388920,20388920,9388920,0.85,0
3623,Barry Lyndon,2006,11000000,20000000,20169934,9169934,0.83,0
3624,Quartet,2011,11000000,18388357,56178935,45178935,4.11,1
3625,Out Cold,2012,11000000,13906394,14786394,3786394,0.34,0
3626,The Ladies Man,2014,11000000,13592872,13719474,2719474,0.25,0
3627,Tomcats,2012,11000000,13558739,13558739,2558739,0.23,0
3628,Inside Llewyn Davis,2016,11000000,13248209,32943247,21943247,1.99,1
3629,Frailty,2019,11000000,13110448,19947280,8947280,0.81,0
3630,Army of Darkness,2020,11000000,11502976,21502976,10502976,0.95,0
3631,Kinsey,2008,11000000,10214647,17443529,6443529,0.59,0
3632,Peeples,2012,11000000,9177065,9307166,-1692834,-0.15,0
3633,What's Eating Gilbert Grape,2007,11000000,9170214,9170214,-1829786,-0.17,0
3634,Boy Erased,2006,11000000,6788692,11862650,862650,0.08,0
3638,Vera Drake,2004,11000000,3753806,13353855,2353855,0.21,0
3639,La piel que habito,2013,11000000,3185193,38190517,27190517,2.47,1
3645,La Tortue Rouge,2001,11000000,920057,6712903,-4287097,-0.39,0
3649,Le prÃ©nom,2007,11000000,61611,25307405,14307405,1.3,0
3650,La famille BÃ©lier,2018,11000000,0,82438670,71438670,6.49,1
3655,Saw V,2006,10800000,56746769,118209778,107409778,9.95,1
3656,Les Intouchables,2016,10800000,13182281,484873045,474073045,43.9,1
3658,Kabhi Alvida Naa Kehna,2000,10750000,3275443,32575443,21825443,2.03,1
3659,Alien,2018,10700000,80930630,203628947,192928947,18.03,1
3661,An Ideal Husband,2007,10700000,18542974,31341183,20641183,1.93,1
3662,Darkness,2006,10600000,22163442,34409206,23809206,2.25,1
3665,2001: A Space Odyssey,2015,10500000,59936321,71923560,61423560,5.85,1
3669,Le Fabuleux destin d'AmÃ©lie Poulain,2012,10350000,33201661,174201661,163851661,15.83,1
3670,PMC: deo beong-keo,2018,10300000,0,12478635,2178635,0.21,0
3671,Lovesick,2018,10100000,10143618,10143618,43618,0.0,0
3675,Good Will Hunting,2017,10000000,138433435,225925989,215925989,21.59,1
3676,The Grudge,2001,10000000,110359362,187281115,177281115,17.73,1
3679,Saw III,2001,10000000,80238724,163876815,153876815,15.39,1
3682,Bring it On,2016,10000000,68353550,90453550,80453550,8.05,1
3684,She's All That,2017,10000000,63465522,63465522,53465522,5.35,1
3685,Saw IV,2010,10000000,63300095,135759694,125759694,12.58,1
3686,Madea's Family Reunion,2002,10000000,63257940,63320521,53320521,5.33,1
3687,White Noise,2015,10000000,56094360,92094360,82094360,8.21,1
3689,Insidious Chapter 3,2017,10000000,52218558,120453155,110453155,11.05,1
3691,Lady Bird,2008,10000000,48958273,78944998,68944998,6.89,1
3692,Precious (Based on the Novel Push by Sapphire),2003,10000000,47566524,68722848,58722848,5.87,1
3694,Hereditary,2018,10000000,44069456,81263489,71263489,7.13,1
3695,"Love, Simon",2002,10000000,40826341,65520633,55520633,5.55,1
3696,Bill &amp; Ted's Excellent Adventure,2000,10000000,40485039,40485039,30485039,3.05,1
3698,Happy Gilmore,2018,10000000,38623460,41004412,31004412,3.1,1
3699,Jigsaw,2016,10000000,38052832,104223315,94223315,9.42,1
3702,Oliver!,2013,10000000,37402877,37402877,27402877,2.74,1
3703,Recess: School's Out,2002,10000000,36696761,44451470,34451470,3.45,1
3704,Mad Max Beyond Thunderdome,2006,10000000,36230219,36230219,26230219,2.62,1
3705,Peteâs Dragon,2015,10000000,36000000,36000000,26000000,2.6,1
3706,The Boy,2016,10000000,35819556,68220952,58220952,5.82,1
3707,Commando,2009,10000000,35073978,35073978,25073978,2.51,1
3710,Friday After Next,2012,10000000,33253609,33526835,23526835,2.35,1
3711,The Second Best Exotic Marigold Hotel,2016,10000000,33078266,90384306,80384306,8.04,1
3712,The Last Dragon,2013,10000000,33000000,33000000,23000000,2.3,1
3713,How to Be a Latin Lover,2010,10000000,32149404,62556228,52556228,5.26,1
3714,The Lawnmower Man,2019,10000000,32100816,32100816,22100816,2.21,1
3715,Nick and Norah's Infinite Playlist,2017,10000000,31487293,33886017,23886017,2.39,1
3716,Calendar Girls,2016,10000000,31011616,93074616,83074616,8.31,1
3718,Slender Man,2001,10000000,30564825,51945949,41945949,4.19,1
3719,The Banger Sisters,2006,10000000,30306281,38067218,28067218,2.81,1
3720,Snatch,2007,10000000,30093107,83593107,73593107,7.36,1
3722,Teen Titans Go! To The Movies,2015,10000000,29790236,51620593,41620593,4.16,1
3724,Twilight Zone: The Movie,2008,10000000,29500000,29500000,19500000,1.95,1
3726,One Direction: This is Us,2005,10000000,28873374,68541786,58541786,5.85,1
3727,Swimfan,2019,10000000,28564995,34084228,24084228,2.41,1
3730,The Forest,2005,10000000,26594261,40749230,30749230,3.07,1
3732,The Outsiders,2002,10000000,25697647,25697647,15697647,1.57,1
3733,Can't Hardly Wait,2016,10000000,25358996,25358996,15358996,1.54,1
3734,Sparkle,2003,10000000,24397469,24660323,14660323,1.47,0
3737,Skyline,2009,10000000,21416355,68264973,58264973,5.83,1
3738,The Grudge,2011,10000000,21216148,49503265,39503265,3.95,1
3739,The Disaster Artist,2014,10000000,21120616,28717667,18717667,1.87,1
3740,Blair Witch,2005,10000000,20777061,38985577,28985577,2.9,1
3741,The Dead Zone,2002,10000000,20766000,20766000,10766000,1.08,0
3742,Valentine,2019,10000000,20384136,20384136,10384136,1.04,0
3743,A Prairie Home Companion,2020,10000000,20342852,26716191,16716191,1.67,1
3744,Reno 911!: Miami,2005,10000000,20342161,21851362,11851362,1.19,0
3746,Paranormal Activity: The Ghost Dimension,2000,10000000,18297124,77959374,67959374,6.8,1
3747,Sugar Hill,2006,10000000,18272447,18423914,8423914,0.84,0
3748,Kit Kittredge: An American Girl,2001,10000000,17657973,17657973,7657973,0.77,0
3749,Invasion U.S.A.,2000,10000000,17536256,17536256,7536256,0.75,0
3752,Rushmore,2019,10000000,17105219,19080435,9080435,0.91,0
3756,Kung Pow: Enter the Fist,2004,10000000,16033556,17033556,7033556,0.7,0
3757,The Birth of a Nation,2012,10000000,15861566,16891011,6891011,0.69,0
3758,Wrong Turn,2018,10000000,15417771,28649556,18649556,1.86,1
3760,The Corruptor,2010,10000000,15164492,15164492,5164492,0.52,0
3761,"The Goods: Live Hard, Sell Hard",2003,10000000,15122676,15297318,5297318,0.53,0
3762,My Week with Marilyn,2014,10000000,14597405,34240572,24240572,2.42,1
3763,Big Eyes,2015,10000000,14482031,27317872,17317872,1.73,1
3764,Broken Flowers,2008,10000000,13744960,40744960,30744960,3.07,1
3765,Hey Arnold! The Movie,2001,10000000,13684949,13684949,3684949,0.37,0
3766,Poms,2012,10000000,13631124,16460336,6460336,0.65,0
3767,Brahms: The Boy II,2006,10000000,12611536,18976477,8976477,0.9,0
3768,The Matador,2016,10000000,12589255,17300838,7300838,0.73,0
3769,Love Jones,2011,10000000,12554569,12554569,2554569,0.26,0
3770,The Gift,2012,10000000,12008642,44567606,34567606,3.46,1
3772,Get Over It,2018,10000000,11560259,19860259,9860259,0.99,0
3773,The Legend of Drunken Master,2004,10000000,11546543,11546543,1546543,0.15,0
3775,Drop Dead Gorgeous,2002,10000000,10571408,10571408,571408,0.06,0
3776,The Best of Enemies,2008,10000000,10205616,10220614,220614,0.02,0
3778,Le Violon rouge,2015,10000000,10019109,10019109,19109,0.0,0
3779,Very Bad Things,2007,10000000,9949470,21094974,11094974,1.11,0
3780,Sleepover,2018,10000000,9408183,9424052,-575948,-0.06,0
3781,Movie 43,2000,10000000,8840453,31164747,21164747,2.12,1
3782,Can You Ever Forgive Me?,2010,10000000,8803865,12517379,2517379,0.25,0
3783,Body Double,2019,10000000,8801940,8801940,-1198060,-0.12,0
3784,MacGruber,2019,10000000,8525600,8629895,-1370105,-0.14,0
3785,Dirty Pretty Things,2001,10000000,8112414,14156753,4156753,0.42,0
3786,Bad Words,2018,10000000,7779614,7843145,-2156855,-0.22,0
3787,While We're Young,2012,10000000,7582065,17503828,7503828,0.75,0
3788,Over Her Dead Body,2016,10000000,7570127,21596074,11596074,1.16,0
3789,Bones,2016,10000000,7316658,8378853,-1621147,-0.16,0
3790,Seeking a Friend for the End of the World,2016,10000000,7078738,11766959,1766959,0.18,0
3791,Turistas,2016,10000000,7027762,14321070,4321070,0.43,0
3793,Cedar Rapids,2012,10000000,6861102,7862131,-2137869,-0.21,0
3796,A.X.L.,2014,10000000,6501381,8259753,-1740247,-0.17,0
3797,Teacher's Pet: The Movie,2000,10000000,6491969,6491969,-3508031,-0.35,0
3799,Deuces Wild,2006,10000000,6044618,6244618,-3755382,-0.38,0
3800,"Run, Fatboy, Run",2011,10000000,6003262,33512260,23512260,2.35,1
3801,Heartbeeps,2016,10000000,6000000,6000000,-4000000,-0.4,0
3802,Danny Collins,2000,10000000,5637066,8465845,-1534155,-0.15,0
3804,Stan &amp; Ollie,2013,10000000,5470235,26293486,16293486,1.63,1
3806,Io sono lâamore,2017,10000000,5005465,15121528,5121528,0.51,0
3810,Gotti,2002,10000000,4286367,6089100,-3910900,-0.39,0
3812,Denial,2006,10000000,4073448,9263940,-736060,-0.07,0
3813,The Man Who Knew Infinity,2012,10000000,3877922,12382122,2382122,0.24,0
3819,The Limey,2007,10000000,3193102,6030047,-3969953,-0.4,0
3827,Sphinx,2004,10000000,2000000,11400000,1400000,0.14,0
3836,Krrish,2016,10000000,1430721,32430721,22430721,2.24,1
3838,Churchill,2012,10000000,1279681,7582196,-2417804,-0.24,0
3844,My Blueberry Nights,2010,10000000,866778,22198996,12198996,1.22,0
3850,Shaolin Soccer,2015,10000000,488872,42776032,32776032,3.28,1
3863,Severance,2014,10000000,137221,5950002,-4049998,-0.4,0
3865,Joheunnom nabbeunnom isanghannom,2015,10000000,128486,42226657,32226657,3.22,1
3878,The Oxford Murders,2015,10000000,4803,17704131,7704131,0.77,0
3880,T-34,2000,10000000,0,35950901,25950901,2.6,1
3883,Jessabelle,2016,10000000,0,6998359,-3001641,-0.3,0
3900,Friend Request,2019,9900000,3759078,11310835,1410835,0.14,0
3902,Adventureland,2008,9800000,16044025,17553055,7753055,0.79,0
3904,Truth,2016,9600000,2541854,6842580,-2757420,-0.29,0
3907,You Only Live Twice,2019,9500000,43100000,111600000,102100000,10.75,1
3908,Poltergeist III,2019,9500000,14114000,14114000,4614000,0.49,0
3909,Dangal,2007,9500000,12391761,305149461,295649461,31.12,1
3913,It's a Mad Mad Mad Mad World,2000,9400000,46300000,60000000,50600000,5.38,1
3914,Volver,2000,9400000,12899867,87226613,77826613,8.28,1
3915,Melancholia,2006,9400000,3030848,21817298,12417298,1.32,0
3916,Heavy Metal,2016,9300000,19571091,19571091,10271091,1.1,0
3917,Jab Tak Hai Jaan,2016,9200000,3047539,5806666,-3393334,-0.37,0
3919,Kites,2004,9200000,1685269,17155193,7955193,0.86,0
3920,Elle,2011,9100000,2339735,16517708,7417708,0.82,0
3922,Mine Vaganti,2016,9100000,0,18872126,9772126,1.07,0
3923,Zarafa,2007,9100000,0,14709816,5609816,0.62,0
3924,The Texas Chainsaw Massacre,2003,9000000,80571655,107967319,98967319,11.0,1
3925,Fiddler on the Roof,2000,9000000,80500000,80500000,71500000,7.94,1
3926,The Purge: Anarchy,2019,9000000,71562550,111534881,102534881,11.39,1
3927,Thunderball,2008,9000000,63600000,141200000,132200000,14.69,1
3928,Escape Room,2002,9000000,57000756,155313078,146313078,16.26,1
3930,The Strangers,2007,9000000,52597610,83051676,74051676,8.23,1
3931,Set It Off,2000,9000000,36049108,36049108,27049108,3.01,1
3932,Ouija: Origin of Evil,2007,9000000,35144505,81831866,72831866,8.09,1
3933,The Best Man,2012,9000000,34102780,34572780,25572780,2.84,1
3934,Child's Play,2016,9000000,33244684,44196684,35196684,3.91,1
3935,Happy Death Day 2U,2018,9000000,28148130,64686515,55686515,6.19,1
3936,Midsommar,2006,9000000,27426363,46843430,37843430,4.2,1
3937,Sicko,2005,9000000,24538513,36535837,27535837,3.06,1
3939,Down to You,2010,9000000,20035310,20035310,11035310,1.23,0
3940,Harold &amp; Kumar Go to White Castle,2003,9000000,18225165,19398156,10398156,1.16,0
3942,Boiler Room,2015,9000000,16963963,28773637,19773637,2.2,1
3943,Black Christmas,2010,9000000,16235738,16235738,7235738,0.8,0
3944,The Edge of Seventeen,2002,9000000,14431633,19096003,10096003,1.12,0
3945,Jackie,2010,9000000,13960394,36588512,27588512,3.07,1
3946,The Ice Pirates,2009,9000000,13075390,13075390,4075390,0.45,0
3947,Breakin' All the Rules,2010,9000000,12232382,12512317,3512317,0.39,0
3948,Glee: The 3D Concert Movie,2006,9000000,11862398,17462398,8462398,0.94,0
3949,Henry V,2015,9000000,10161099,10176701,1176701,0.13,0
3950,Loving,2013,9000000,7710234,12898064,3898064,0.43,0
3951,The Savages,2014,9000000,6623082,10642023,1642023,0.18,0
3952,Chasing Papi,2012,9000000,6126237,12657377,3657377,0.41,0
3954,The Sun is Also a Star,2013,9000000,4950029,5680796,-3319204,-0.37,0
3956,Igby Goes Down,2015,9000000,4777465,5512151,-3487849,-0.39,0
3961,The Sapphires,2019,9000000,2450867,20395040,11395040,1.27,0
3970,Dheepan,2013,9000000,248795,7704357,-1295643,-0.14,0
3978,Les gamins,2001,9000000,0,15660664,6660664,0.74,0
3983,Polisse,2016,8900000,176988,22744132,13844132,1.56,1
3986,Crocodile Dundee,2013,8800000,174803506,328203506,319403506,36.3,1
3989,Awake,2010,8600000,14373825,32968648,24368648,2.83,1
3998,The Rose,2006,8500000,29200000,29200000,20700000,2.44,1
3999,Baggage Claim,2010,8500000,21569509,22885836,14385836,1.69,1
4001,Haakon Haakonsen,2003,8500000,15024232,15024232,6524232,0.77,0
4003,The Namesake,2004,8500000,13610521,20288774,11788774,1.39,0
4004,All is Lost,2019,8500000,6263670,10386814,1886814,0.22,0
4005,Club Dread,2011,8500000,5001655,7573551,-926449,-0.11,0
4011,Posledniy bogatyr,2008,8500000,0,30700192,22200192,2.61,1
4017,The Wind That Shakes the Barley,2006,8300000,1829142,25670174,17370174,2.09,1
4020,Quo Vadis?,2013,8250000,30000000,30028684,21778684,2.64,1
4022,Footloose,2009,8200000,80000000,80003527,71803527,8.76,1
4024,Pulp Fiction,2000,8000000,107928762,212911910,204911910,25.61,1
4025,The Karate Kid,2006,8000000,90815558,90815558,82815558,10.35,1
4026,The Muppet Movie,2002,8000000,76657000,76657000,68657000,8.58,1
4027,Splash,2006,8000000,62599495,62599495,54599495,6.82,1
4028,Little Miss Sunshine,2009,8000000,59891098,100642353,92642353,11.58,1
4029,Easy A,2011,8000000,58401464,76200721,68200721,8.53,1
4031,28 Days Laterâ¦,2000,8000000,45064915,82955633,74955633,9.37,1
4032,Escape from Alcatraz,2015,8000000,43000000,43000000,35000000,4.38,1
4033,You Got Served,2010,8000000,40066497,50811858,42811858,5.35,1
4036,A Thin Line Between Love &amp; Hate,2000,8000000,34873513,34873513,26873513,3.36,1
4037,A Walk in the Woods,2000,8000000,29499394,37119358,29119358,3.64,1
4038,Brown Sugar,2016,8000000,27362712,28315272,20315272,2.54,1
4039,Howards End,2016,8000000,26124872,26317849,18317849,2.29,1
4040,That Awkward Moment,2005,8000000,26068955,53068955,45068955,5.63,1
4041,Shutter,2010,8000000,25928550,47782426,39782426,4.97,1
4042,Modern Problems,2002,8000000,24474312,24474312,16474312,2.06,1
4045,The Player,2013,8000000,21706101,28876702,20876702,2.61,1
4046,Creepshow,2018,8000000,20036244,20036244,12036244,1.5,1
4047,Akeelah and the Bee,2010,8000000,18848430,18959424,10959424,1.37,0
4048,Wes Craven's New Nightmare,2008,8000000,18090181,18090181,10090181,1.26,0
4049,Drive Me Crazy,2019,8000000,17843379,22591451,14591451,1.82,1
4050,Enough Said,2010,8000000,17550872,25621449,17621449,2.2,1
4051,Half Baked,2016,8000000,17394881,17394881,9394881,1.17,0
4054,American Psycho,2006,8000000,15070285,34270285,26270285,3.28,1
4055,See No Evil,2007,8000000,15032800,18828036,10828036,1.35,0
4056,The Good Girl,2020,8000000,14018296,16585503,8585503,1.07,0
4057,"Bon Cop, Bad Cop",2003,8000000,12671300,12740705,4740705,0.59,0
4058,The Boondock Saints 2: All Saints Day,2016,8000000,10273187,10629320,2629320,0.33,0
4059,Prom,2007,8000000,10130219,10763183,2763183,0.35,0
4060,The Inkwell,2018,8000000,8864699,8864699,864699,0.11,0
4061,Shadow of the Vampire,2011,8000000,8279017,8279017,279017,0.03,0
4063,It's Kind of a Funny Story,2007,8000000,6363628,6632950,-1367050,-0.17,0
4064,Under Fire,2010,8000000,5696391,5696391,-2303609,-0.29,0
4065,The Pallbearer,2008,8000000,5656388,5656388,-2343612,-0.29,0
4066,Woman on Top,2012,8000000,5018450,10192613,2192613,0.27,0
4068,Morgan,2006,8000000,3915251,7298786,-701214,-0.09,0
4069,Anomalisa,2015,8000000,3759286,5706168,-2293832,-0.29,0
4070,CachÃ©,2011,8000000,3647381,19891331,11891331,1.49,0
4071,Another Year,2005,8000000,3205706,20005613,12005613,1.5,1
4072,8 femmes,2001,8000000,3076425,42376425,34376425,4.3,1
4075,Le passÃ©,2007,8000000,1335672,15752575,7752575,0.97,0
4077,Made in Dagenham,2019,8000000,1095369,15644196,7644196,0.96,0
4088,Ma vie de Courgette,2015,8000000,309768,10245743,2245743,0.28,0
4097,A Street Cat Named Bob,2009,8000000,82703,17382693,9382693,1.17,0
4104,Feichang Xingyun,2004,8000000,0,21970000,13970000,1.75,1
4117,Swimming Pool,2005,7800000,10130108,24021282,16221282,2.08,1
4118,Dvizhenie Vverkh,2007,7800000,0,61925449,54125449,6.94,1
4123,Soul Food,2011,7500000,43492389,43492389,35992389,4.8,1
4124,(500) Days of Summer,2007,7500000,32425665,34308515,26808515,3.57,1
4126,Thank You For Smoking,2012,7500000,24793509,40016662,32516662,4.34,1
4128,An Education,2018,7500000,12574914,29652736,22152736,2.95,1
4129,Extract,2020,7500000,10823158,10849158,3349158,0.45,0
4130,Narc,2019,7500000,10465659,11843260,4343260,0.58,0
4136,Albert Nobbs,2003,7500000,3014696,8539003,1039003,0.14,0
4147,The Bye Bye Man,2001,7400000,22395806,31187727,23787727,3.21,1
4151,Harry Brown,2000,7300000,1818681,12023606,4723606,0.65,0
4152,Die Welle,2015,7250000,0,35122948,27872948,3.84,1
4153,Diamonds Are Forever,2019,7200000,43800000,116000000,108800000,15.11,1
4154,The Omega Code,2005,7200000,12610552,12678312,5478312,0.76,0
4157,The Godfather,2014,7000000,134966411,268500000,261500000,37.36,1
4160,I Can Only Imagine,2003,7000000,83482352,85767364,78767364,11.25,1
4162,Five Feet Apart,2003,7000000,45729221,91513111,84513111,12.07,1
4163,Pee Wee's Big Adventure,2009,7000000,40940662,40940662,33940662,4.85,1
4164,The Piano,2010,7000000,40157856,40190464,33190464,4.74,1
4165,Jumping the Broom,2009,7000000,37295394,38158601,31158601,4.45,1
4168,Darkness Falls,2010,7000000,32539681,47289758,40289758,5.76,1
4170,"Good Night, and Good Luck",2005,7000000,31501218,56586901,49586901,7.08,1
4171,Capote,2002,7000000,28750530,49924079,42924079,6.13,1
4172,The Great Gatsby,2007,7000000,26533200,26533200,19533200,2.79,1
4175,Desperado,2001,7000000,25532388,25532388,18532388,2.65,1
4178,Fargo,2004,7000000,24567751,51204567,44204567,6.31,1
4179,Kingdom Come,2008,7000000,23247539,23393939,16393939,2.34,1
4181,Action Jackson,2002,7000000,20257000,20257000,13257000,1.89,1
4182,Breathless,2018,7000000,19910002,19910002,12910002,1.84,1
4183,Michael Jordan to the MAX,2011,7000000,18642318,18642318,11642318,1.66,1
4184,Dope,2010,7000000,17506470,18190831,11190831,1.6,1
4185,BrightBurn,2012,7000000,17259427,33183642,26183642,3.74,1
4186,The Devil's Rejects,2007,7000000,17044981,20940428,13940428,1.99,1
4187,Devil's Due,2013,7000000,15821461,36146087,29146087,4.16,1
4188,Flirting with Disaster,2009,7000000,14853474,16149180,9149180,1.31,0
4190,Buffy the Vampire Slayer,2010,7000000,14231669,14231669,7231669,1.03,0
4193,Silver Bullet,2015,7000000,10803211,10803211,3803211,0.54,0
4194,House of the Dead,2013,7000000,10199354,13860078,6860078,0.98,0
4195,A Serious Man,2010,7000000,9228788,30360570,23360570,3.34,1
4196,Get Low,2011,7000000,9176933,10828305,3828305,0.55,0
4198,Warlock,2003,7000000,8824553,8824553,1824553,0.26,0
4199,The Last Temptation of Christ,2006,7000000,8373585,8373585,1373585,0.2,0
4200,Cyrus,2003,7000000,7468936,10062896,3062896,0.44,0
4201,Outside Providence,2010,7000000,7309628,7824358,824358,0.12,0
4202,Bride &amp; Prejudice,2015,7000000,6601079,25269040,18269040,2.61,1
4203,Rabbit-Proof Fence,2000,7000000,6199600,16866928,9866928,1.41,0
4204,Who's Your Caddy?,2012,7000000,5694308,5694308,-1305692,-0.19,0
4210,Veer-Zaara,2007,7000000,2938532,7017859,17859,0.0,0
4217,We Need to Talk About Kevin,2017,7000000,1738692,10765283,3765283,0.54,0
4222,Mother and Child,2010,7000000,1110509,6537179,-462821,-0.07,0
4224,Les Visiteurs,2010,7000000,659000,98754000,91754000,13.11,1
4236,Snezhnaya koroleva,2006,7000000,0,15193977,8193977,1.17,0
4246,Pale Rider,2004,6900000,41410568,41410568,34510568,5.0,1
4247,House at the End of the Street,2001,6900000,31611916,44103982,37203982,5.39,1
4250,Incendies,2016,6800000,6857096,16038343,9238343,1.36,0
4253,Shade,2016,6800000,25032,9533964,2733964,0.4,0
4254,Bran Nue Dae,2008,6750000,113568,6812530,62530,0.01,0
4258,Annabelle,2009,6500000,84273813,256862920,250362920,38.52,1
4263,Dressed to Kill,2004,6500000,31899000,31899000,25399000,3.91,1
4267,Go!,2018,6500000,16875273,28383441,21883441,3.37,1
4271,Same Kind of Different as Me,2019,6500000,6423605,6423605,-76395,-0.01,0
4272,Nowhere in Africa,2001,6500000,6173485,6568446,68446,0.01,0
4273,Shame,2008,6500000,4002293,20412841,13912841,2.14,1
4281,The Terminator,2002,6400000,38019031,78019031,71619031,11.19,1
4284,Control,2000,6400000,871577,8902141,2502141,0.39,0
4286,Adopte un veuf,2003,6400000,0,9394401,2994401,0.47,0
4287,Die FÃ¤lscher,2019,6250000,5488570,20199663,13949663,2.23,1
4288,Trener,2018,6250000,0,14261269,8011269,1.28,0
4290,Return of the Living Dead Part II,2007,6200000,9205924,9205924,3005924,0.48,0
4297,Fahrenheit 9/11,2012,6000000,119114517,221148959,215148959,35.86,1
4299,Mary Poppins,2015,6000000,102272145,102275664,96275664,16.05,1
4300,Ordinary People,2012,6000000,52302978,52302978,46302978,7.72,1
4301,Breaking In,2000,6000000,46840590,51485382,45485382,7.58,1
4302,West Side Story,2008,6000000,43700000,43700000,37700000,6.28,1
4304,Caddyshack,2010,6000000,39846344,39849764,33849764,5.64,1
4305,Ready or Not,2018,6000000,28714231,56797392,50797392,8.47,1
4306,The Brothers,2012,6000000,27457409,27958191,21958191,3.66,1
4307,The Wrestler,2011,6000000,26238243,46634275,40634275,6.77,1
4308,Do the Right Thing,2000,6000000,26004026,26051619,20051619,3.34,1
4309,Escape from New York,2008,6000000,25244700,25245925,19245925,3.21,1
4310,The Wood,2006,6000000,25059640,25059640,19059640,3.18,1
4312,Chinatown,2009,6000000,23169837,23169837,17169837,2.86,1
4314,A Nightmare On Elm Street: The Dream Child,2014,6000000,22168359,22168359,16168359,2.69,1
4315,National Lampoonâs Van Wilder,2006,6000000,21305259,39241323,33241323,5.54,1
4316,Duel in the Sun,2014,6000000,20400000,20400000,14400000,2.4,1
4318,Best in Show,2001,6000000,18621249,20695413,14695413,2.45,1
4319,The Last King of Scotland,2003,6000000,17606684,49155371,43155371,7.19,1
4320,A Mighty Wind,2008,6000000,17583468,18504539,12504539,2.08,1
4321,The Prodigy,2001,6000000,14856291,19789712,13789712,2.3,1
4322,The Possession of Hannah Grace,2009,6000000,14836174,42873730,36873730,6.15,1
4323,School Daze,2011,6000000,14545844,14545844,8545844,1.42,0
4324,Daddy Day Camp,2018,6000000,13235267,18209872,12209872,2.03,1
4325,Mystic Pizza,2001,6000000,12793213,12793213,6793213,1.13,0
4326,Mr. Nice Guy,2011,6000000,12716953,31716953,25716953,4.29,1
4329,Tales from the Hood,2011,6000000,11784569,11784569,5784569,0.96,0
4331,The Words,2002,6000000,11494838,16369708,10369708,1.73,1
4332,The Year of Living Dangerously,2003,6000000,10278575,10278575,4278575,0.71,0
4333,The Lady in the Van,2011,6000000,10021175,42320503,36320503,6.05,1
4334,Bernie,2006,6000000,9204489,10106975,4106975,0.68,0
4335,Pollock,2010,6000000,8596914,10557291,4557291,0.76,0
4336,Dolphins and Whales Tribes of the Ocean 3D,2015,6000000,7714996,17252287,11252287,1.88,1
4337,200 Cigarettes,2012,6000000,6852450,6852450,852450,0.14,0
4338,City Island,2009,6000000,6671283,8173486,2173486,0.36,0
4339,Unbroken: Path to Redemption,2001,6000000,6216897,6216897,216897,0.04,0
4340,Casa de mi Padre,2008,6000000,5909483,8446952,2446952,0.41,0
4341,The Guard,2015,6000000,5359774,21197454,15197454,2.53,1
4342,The Virgin Suicides,2007,6000000,4859475,10619770,4619770,0.77,0
4343,College,2010,6000000,4694491,6176114,176114,0.03,0
4344,La science des rÃªves,2017,6000000,4670644,15137932,9137932,1.52,1
4345,Little Voice,2017,6000000,4595000,21787233,15787233,2.63,1
4349,Venus,2011,6000000,3347411,7818479,1818479,0.3,0
4357,Snow Flower and the Secret Fan,2008,6000000,1348205,11348205,5348205,0.89,0
4360,JÃ»san-nin no shikaku,2006,6000000,802778,18727440,12727440,2.12,1
4367,Akmareul Boatda,2010,6000000,129210,13168809,7168809,1.19,0
4378,Ãpouse-moi mon pote,2017,6000000,0,22367263,16367263,2.73,1
4379,Prityazhenie,2001,6000000,0,19594567,13594567,2.27,1
4388,Emma,2002,5900000,22231658,37831658,31931658,5.41,1
4390,Planet of the Apes,2011,5800000,33395426,33396833,27596833,4.76,1
4391,The Train,2015,5800000,6800000,6800000,1000000,0.17,0
4392,Winter in Wartime,2014,5800000,542860,9662214,3862214,0.67,0
4395,Tom yum goong,2013,5700000,12044087,43044087,37344087,6.55,1
4397,The Inbetweeners,2017,5700000,35955,86051320,80351320,14.1,1
4399,Bend it Like Beckham,2012,5600000,32543449,74566042,68966042,12.32,1
4400,Crossover,2013,5600000,7009668,7009668,1409668,0.25,0
4403,Khiladi 786,2000,5600000,385422,14683763,9083763,1.62,1
4404,[Rec] 2,2016,5600000,27766,18527766,12927766,2.31,1
4406,Chariots of Fire,2005,5500000,61558162,61865947,56365947,10.25,1
4407,Diary of a Mad Black Woman,2011,5500000,50406346,50458356,44958356,8.17,1
4408,Shine,2019,5500000,35811509,36675932,31175932,5.67,1
4410,High Plains Drifter,2002,5500000,15700000,15700000,10200000,1.85,1
4411,Hell Fest,2017,5500000,11107431,18119231,12619231,2.29,1
4412,Mambo Italiano,2017,5500000,9282750,12399772,6899772,1.25,0
4413,Loving Vincent,2011,5500000,6735118,44357515,38857515,7.07,1
4414,Ghost World,2005,5500000,6217849,8761608,3261608,0.59,0
4415,Iris,2013,5500000,5580479,5692941,192941,0.04,0
4417,Les Choristes,2015,5500000,3629758,83529758,78029758,14.19,1
4419,De battre mon coeur s'est arrÃªtÃ©,2017,5500000,1023424,8589831,3089831,0.56,0
4420,Haevnen,2012,5500000,1008098,15867314,10367314,1.88,1
4421,Le Havre,2014,5500000,611709,13480196,7980196,1.45,0
4422,El Clan,2019,5500000,201227,22125102,16625102,3.02,1
4432,Portrait de la jeune fille en feu,2014,5360529,3759854,9278359,3917830,0.73,0
4434,Rang De Basanti,2014,5300000,2197694,29197694,23897694,4.51,1
4436,La Vie d'AdÃ¨le â Chapitres 1 &amp; 2,2015,5250000,2450504,22895151,17645151,3.36,1
4444,Rebelles,2000,5200000,0,7260661,2060661,0.4,0
4445,Somewhere in Time,2013,5100000,9709597,9709597,4609597,0.9,0
4446,My Big Fat Greek Wedding,2014,5000000,241438208,374890034,369890034,73.98,1
4447,Get Out,2016,5000000,176040665,253875477,248875477,49.78,1
4452,Lights Out,2016,5000000,67268835,148806510,143806510,28.76,1
4454,Jackass: The Movie,2015,5000000,64282312,79282312,74282312,14.86,1
4456,Paranormal Activity 4,2011,5000000,53900335,142817992,137817992,27.56,1
4457,Ouija,2018,5000000,50856010,103300632,98300632,19.66,1
4458,MA,2014,5000000,45896028,61149753,56149753,11.23,1
4459,A Nightmare On Elm Street 3: Dream Warriors,2001,5000000,44793222,44793222,39793222,7.96,1
4460,No se Aceptan Devoluciones,2020,5000000,44467206,100486616,95486616,19.1,1
4466,Overcomer,2013,5000000,34700142,37648235,32648235,6.53,1
4467,Monster,2017,5000000,34469210,64200321,59200321,11.84,1
4468,Paranormal Activity: The Marked Ones,2002,5000000,32462372,90904854,85904854,17.18,1
4469,"20,000 Leagues Under the Sea",2004,5000000,28200000,28200000,23200000,4.64,1
4470,Oculus,2008,5000000,27695246,44115496,39115496,7.82,1
4471,Dallas Buyers Club,2016,5000000,27298285,60611845,55611845,11.12,1
4475,Memento,2017,5000000,25544867,39723096,34723096,6.94,1
4477,The Strangers: Prey at Night,2009,5000000,24431472,32144262,27144262,5.43,1
4478,Clerks II,2016,5000000,24148068,27342246,22342246,4.47,1
4482,"As Above, So Below",2009,5000000,21222315,41824066,36824066,7.36,1
4483,Godâs Not Dead 2,2019,5000000,20773069,23551286,18551286,3.71,1
4484,The Apostle,2014,5000000,20733485,21277770,16277770,3.26,1
4485,The Man From Snowy River,2017,5000000,20659423,20659423,15659423,3.13,1
4486,House Party 2,2016,5000000,19438638,19438638,14438638,2.89,1
4487,Doug's 1st Movie,2000,5000000,19421271,19421271,14421271,2.88,1
4488,Race,2004,5000000,19115191,23745772,18745772,3.75,1
4489,Mommie Dearest,2003,5000000,19032000,25032000,20032000,4.01,1
4492,Apollo 18,2001,5000000,17686929,26517819,21517819,4.3,1
4493,"Paul, Apostle of Christ",2019,5000000,17547999,25529498,20529498,4.11,1
4494,Addicted,2018,5000000,17390770,17499242,12499242,2.5,1
4496,Gretel &amp; Hansel,2010,5000000,15347654,20705686,15705686,3.14,1
4497,Halloween: The Curse of Michael Myers,2006,5000000,15126948,15126948,10126948,2.03,1
4498,The Egyptian,2016,5000000,15000000,15000000,10000000,2.0,1
4501,Friday the 13th Part VIII: Jason Takes Manhattan,2001,5000000,14343976,14343976,9343976,1.87,1
4502,Spring Breakers,2019,5000000,14124286,31149251,26149251,5.23,1
4503,It Comes at Night,2004,5000000,13985117,19720203,14720203,2.94,1
4504,Y Tu MamÃ¡ TambiÃ©n,2009,5000000,13649881,33649881,28649881,5.73,1
4505,Shaun of the Dead,2015,5000000,13542874,30332385,25332385,5.07,1
4506,The Haunting of Molly Hartley,2016,5000000,13442412,15318257,10318257,2.06,1
4507,Hillaryâs America: The Secret History of the De…,2006,5000000,13099931,13099931,8099931,1.62,1
4509,April Fool's Day,2008,5000000,12947763,12947763,7947763,1.59,1
4510,Diner,2014,5000000,12592907,12592907,7592907,1.52,1
4511,Before I Fall,2011,5000000,12241072,18945682,13945682,2.79,1
4513,Sunshine Cleaning,2017,5000000,12062558,17329337,12329337,2.47,1
4514,Fifty Shades of Black,2019,5000000,11686940,22113075,17113075,3.42,1
4515,A Farewell To Arms,2016,5000000,11000000,11017403,6017403,1.2,0
4516,Solomon and Sheba,2018,5000000,11000000,11014961,6014961,1.2,0
4518,Not Easily Broken,2016,5000000,10572742,10732909,5732909,1.15,0
4519,Black Christmas,2011,5000000,10429730,18528789,13528789,2.71,1
4520,Momsâ Night Out,2014,5000000,10429707,10537341,5537341,1.11,0
4521,The Belko Experiment,2010,5000000,10166820,11792942,6792942,1.36,0
4522,The Perfect Match,2015,5000000,9669521,10182050,5182050,1.04,0
4523,Digimon: The Movie,2016,5000000,9628751,16628751,11628751,2.33,1
4526,Robin and Marian,2004,5000000,8000000,8000000,3000000,0.6,0
4528,The Forsaken,2008,5000000,6755271,6755271,1755271,0.35,0
4529,Jexi,2014,5000000,6546159,10599971,5599971,1.12,0
4530,Fahrenheit 11/9,2003,5000000,6352306,6653715,1653715,0.33,0
4531,UHF,2006,5000000,6157157,6157157,1157157,0.23,0
4533,Grandmaâs Boy,2013,5000000,6090172,6590172,1590172,0.32,0
4535,Slums of Beverly Hills,2014,5000000,5502773,5502773,502773,0.1,0
4537,Made,2008,5000000,5308707,5476060,476060,0.1,0
4540,Moon,2015,5000000,5010163,10676073,5676073,1.14,0
4542,Incarnate,2003,5000000,4799774,9371036,4371036,0.87,0
4544,The Sweet Hereafter,2004,5000000,4306697,7951247,2951247,0.59,0
4546,My Old Lady,2007,5000000,4011530,15220308,10220308,2.04,1
4547,Des Hommes et Des Dieux,2014,5000000,3954651,46263525,41263525,8.25,1
4554,The Other Side of the Door,2014,5000000,3000342,12905107,7905107,1.58,1
4556,Kill the Messenger,2009,5000000,2450846,6656705,1656705,0.33,0
4557,Rabbit Hole,2007,5000000,2229058,6205034,1205034,0.24,0
4559,Paterson,2014,5000000,2141423,10727536,5727536,1.15,0
4562,The Machinist,2015,5000000,1082044,8655397,3655397,0.73,0
4588,Mientras duermes,2011,5000000,0,9109597,4109597,0.82,0
4609,Every Day,2011,4900000,6112914,12826031,7926031,1.62,1
4610,Mommy,2003,4900000,3498695,17536004,12636004,2.58,1
4611,Obsluhoval jsem anglickÃ©ho krÃ¡le,2010,4900000,617228,7174984,2274984,0.46,0
4612,Soul Kitchen,2006,4900000,276901,23347461,18447461,3.76,1
4613,The Awakening,2011,4900000,95933,6924321,2024321,0.41,0
4615,Sling Blade,2003,4833610,24475416,34175000,29341390,6.07,1
4616,Hostel,2010,4800000,47326473,82241110,77441110,16.13,1
4620,The Texas Chainsaw Massacre 2,2012,4700000,8025872,8025872,3325872,0.71,0
4625,Pat Garrett and Billy the Kid,2015,4638783,8000000,11000000,6361217,1.37,0
4630,Le nom des gens,2015,4600000,514237,9261711,4661711,1.01,0
4633,Police Academy,2001,4500000,81198894,81198894,76698894,17.04,1
4634,Four Weddings and a Funeral,2009,4500000,52700832,242895809,238395809,52.98,1
4635,The Blue Lagoon,2012,4500000,47923795,47923795,43423795,9.65,1
4637,Secrets &amp; Lies,2006,4500000,13417292,13417292,8917292,1.98,1
4638,25th Hour,2010,4500000,13084595,25344490,20844490,4.63,1
4639,After Hours,2010,4500000,10609321,10609321,6109321,1.36,0
4640,Moby Dick,2011,4500000,10400000,10400000,5900000,1.31,0
4641,The Lobster,2006,4500000,9196278,18019834,13519834,3.0,1
4648,Donnie Darko,2015,4500000,1480006,7510877,3010877,0.67,0
4654,Chinjeolhan geumjassi,2010,4500000,211667,23471871,18971871,4.22,1
4669,One Flew Over the Cuckoo's Nest,2001,4400000,108981275,108997629,104597629,23.77,1
4670,Silent Movie,2000,4400000,36145695,36145695,31745695,7.21,1
4671,Airlift (2016),2008,4400000,0,9969237,5569237,1.27,0
4674,Whale Rider,2006,4300000,20779666,39374600,35074600,8.16,1
4676,Paa,2007,4300000,199228,9791282,5491282,1.28,0
4677,Snabba Cash,2007,4300000,188870,10212403,5912403,1.37,0
4678,Night of the Living Dead,2002,4200000,5835247,5835247,1635247,0.39,0
4680,Animal Kingdom,2006,4200000,1044039,8078683,3878683,0.92,0
4687,The Crying Game,2012,4000000,62546695,62546695,58546695,14.64,1
4688,Lost in Translation,2007,4000000,44585453,117085297,113085297,28.27,1
4689,Annie Hall,2018,4000000,38251425,38251425,34251425,8.56,1
4690,The Boy Next Door,2011,4000000,36006065,53401938,49401938,12.35,1
4691,The Greatest Show on Earth,2005,4000000,36000000,36000000,32000000,8.0,1
4692,Leaving Las Vegas,2011,4000000,31983777,49800000,45800000,11.45,1
4693,Monster's Ball,2005,4000000,31273922,43766463,39766463,9.94,1
4695,Exodus,2012,4000000,21750000,21750000,17750000,4.44,1
4696,The Kids Are All Right,2014,4000000,20811365,36275469,32275469,8.07,1
4697,Life of Brian,2003,4000000,20182359,20514067,16514067,4.13,1
4699,Late Night,2013,4000000,15500045,22373378,18373378,4.59,1
4700,The Last Exorcism Part II,2014,4000000,15179303,25448707,21448707,5.36,1
4703,The Return of the Living Dead,2009,4000000,14237880,14237880,10237880,2.56,1
4704,They Live,2000,4000000,13000000,13000774,9000774,2.25,1
4705,Saving Grace,2000,4000000,12178602,27786849,23786849,5.95,1
4706,The Great Escape,2016,4000000,11744471,11972561,7972561,1.99,1
4707,What the #$'! Do We Know,2014,4000000,10941801,10941801,6941801,1.74,1
4708,The Lighthouse,2014,4000000,10867104,18206015,14206015,3.55,1
4709,The Darkness,2003,4000000,10753574,10898293,6898293,1.72,1
4710,Scoop,2015,4000000,10525717,40103262,36103262,9.03,1
4711,The Wash,2010,4000000,10097096,10097096,6097096,1.52,1
4712,3 Strikes,2011,4000000,9821335,9821335,5821335,1.46,0
4713,The Visitor,2000,4000000,9427026,19174817,15174817,3.79,1
4716,The Night Listener,2011,4000000,7836393,10770993,6770993,1.69,1
4717,The Jerky Boys,2014,4000000,7555256,7555256,3555256,0.89,0
4718,El orfanato,2002,4000000,7159147,79250193,75250193,18.81,1
4720,The Rules of Attraction,2014,4000000,6525762,11799060,7799060,1.95,1
4721,Topaz,2011,4000000,6000000,6000000,2000000,0.5,0
4724,Secretary,2013,4000000,4046737,9412015,5412015,1.35,0
4731,CafarnaÃºm,2012,4000000,1660708,65813793,61813793,15.45,1
4753,Tau ming chong,2006,4000000,129078,38899792,34899792,8.72,1
4765,Perfectos Desconocidos,2018,4000000,0,31166312,27166312,6.79,1
4782,A Man for All Seasons,2018,3900000,28350000,28350000,24450000,6.27,1
4783,Ben-Hur: A Tale of the Christ,2001,3900000,9000000,9000000,5100000,1.31,0
4785,Network,2016,3800000,23689877,23689877,19889877,5.23,1
4791,Annie Get Your Gun,2016,3768785,8000000,8000000,4231215,1.12,0
4793,Four Lions,2005,3750000,310007,8607693,4857693,1.3,0
4799,The History Boys,2006,3700000,2730296,13447998,9747998,2.63,1
4801,Midnight Cowboy,2013,3600000,44785053,44796329,41196329,11.44,1
4804,Airplane!,2015,3500000,83453539,83453539,79953539,22.84,1
4805,M*A*S*H,2012,3500000,81600000,81600000,78100000,22.31,1
4806,The Full Monty,2015,3500000,45950122,261249383,257749383,73.64,1
4807,Truth or Dare,2005,3500000,41411015,95292744,91792744,26.23,1
4809,Friday,2011,3500000,27467564,27936778,24436778,6.98,1
4810,The Witch,2008,3500000,25138705,40454520,36954520,10.56,1
4811,Winchester,2004,3500000,25091816,45960255,42460255,12.13,1
4812,Call Me by Your Name,2007,3500000,18065180,41719534,38219534,10.92,1
4813,Empire,2008,3500000,17504595,18495444,14995444,4.28,1
4814,Dark Skies,2015,3500000,17418667,27704111,24204111,6.92,1
4815,Forever My Girl,2015,3500000,16376066,16376066,12876066,3.68,1
4817,In Cold Blood,2014,3500000,13000000,13007551,9507551,2.72,1
4818,The Nun's Story,2007,3500000,12800000,12800000,9300000,2.66,1
4819,Frenzy,2003,3500000,12600000,12600000,9100000,2.6,1
4820,Harper,2000,3500000,12000000,12000000,8500000,2.43,1
4821,I Got the Hook-Up!,2006,3500000,10317779,10317779,6817779,1.95,1
4822,She's the One,2015,3500000,9482579,13795053,10295053,2.94,1
4825,El secreto de sus ojos,2009,3500000,6391436,40527719,37027719,10.58,1
4854,High Anxiety,2002,3400000,31063038,31063038,27663038,8.14,1
4865,Bella,2018,3300000,8093373,12405473,9105473,2.76,1
4866,Cidade de Deus,2006,3300000,7563397,32059295,28759295,8.71,1
4874,Rosemary's Baby,2001,3200000,33395426,33396740,30196740,9.44,1
4875,Sorry to Bother You,2013,3200000,17493096,18285560,15085560,4.71,1
4877,Maria Full of Grace,2009,3200000,6529624,14441158,11241158,3.51,1
4879,The Meddler,2017,3200000,4267219,5526942,2326942,0.73,0
4882,Itâs a Wonderful Life,2002,3180000,6600000,10768908,7588908,2.39,1
4885,National Lampoon's Animal House,2019,3000000,141600000,141600000,138600000,46.2,1
4886,Paranormal Activity 2,2016,3000000,84752907,177512032,174512032,58.17,1
4887,War Room,2016,3000000,67790117,73986904,70986904,23.66,1
4888,The Purge,2000,3000000,64473115,91266581,88266581,29.42,1
4889,Goldfinger,2000,3000000,51100000,124900000,121900000,40.63,1
4891,The Original Kings of Comedy,2013,3000000,38168022,38236338,35236338,11.75,1
4892,The Bridge on the River Kwai,2010,3000000,33300000,33300000,30300000,10.1,1
4897,A Nightmare on Elm Street Part 2: Freddy's Revenge,2002,3000000,21163999,21163999,18163999,6.05,1
4898,A Room with a View,2016,3000000,20966644,21033165,18033165,6.01,1
4901,Martin Lawrence Live: RunTelDat,2006,3000000,19184820,19184820,16184820,5.39,1
4902,The Apartment,2010,3000000,18600000,24600000,21600000,7.2,1
4904,Cat on a Hot Tin Roof,2013,3000000,17570324,17570324,14570324,4.86,1
4905,Beneath the Planet of the Apes,2003,3000000,17489009,17489009,14489009,4.83,1
4906,Pokemon 3: The Movie,2014,3000000,17052128,68452128,65452128,21.82,1
4907,Jason Goes to Hell: The Final Friday,2017,3000000,15935068,15935068,12935068,4.31,1
4908,Spaced Invaders,2003,3000000,15000000,15000000,12000000,4.0,1
4909,The Case for Christ,2012,3000000,14678714,17966760,14966760,4.99,1
4910,Family Plot,2003,3000000,13200000,13200000,10200000,3.4,1
4911,Torn Curtain,2011,3000000,13000000,13000000,10000000,3.33,1
4912,Upgrade,2015,3000000,11977130,16976561,13976561,4.66,1
4913,Dave Chappelle's Block Party,2012,3000000,11718595,12051924,9051924,3.02,1
4914,Krush Groove,2010,3000000,11052713,11052713,8052713,2.68,1
4915,Elmer Gantry,2008,3000000,10400000,10400000,7400000,2.47,1
4916,Next Day Air,2011,3000000,10027047,10172519,7172519,2.39,1
4917,Judgment at Nuremberg,2016,3000000,10000000,10000000,7000000,2.33,1
4919,Trippinâ,2006,3000000,9017070,9017070,6017070,2.01,1
4921,The Deep End,2010,3000000,8823109,9981635,6981635,2.33,1
4922,Before Midnight,2012,3000000,8110621,23251930,20251930,6.75,1
4923,Teen Wolf Too,2007,3000000,7888000,7888000,4888000,1.63,1
4924,The Collector,2010,3000000,7712114,10473836,7473836,2.49,1
4925,Phantasm II,2008,3000000,7282851,7282851,4282851,1.43,0
4926,Let There Be Light,2006,3000000,7233471,7241309,4241309,1.41,0
4927,Phat Girlz,2014,3000000,7061128,7301115,4301115,1.43,0
4929,Real Women Have Curves,2000,3000000,5853194,7777790,4777790,1.59,1
4930,Gallipoli,2015,3000000,5732587,5732587,2732587,0.91,0
4931,Water,2012,3000000,5529144,11322573,8322573,2.77,1
4934,Swiss Army Man,2015,3000000,4210454,5837111,2837111,0.95,0
4935,East is East,2008,3000000,4170647,30438635,27438635,9.15,1
4948,Tsotsi,2015,3000000,2912606,11537539,8537539,2.85,1
4955,Elephant,2010,3000000,1266955,10051516,7051516,2.35,1
4961,Fish Tank,2005,3000000,374675,5922292,2922292,0.97,0
5001,Cinderella,2012,2900000,85000000,263591415,260691415,89.89,1
5002,Central do Brasil,2003,2900000,5969553,17006158,14106158,4.86,1
5007,Some Like it Hot,2003,2883848,25000000,25019542,22135694,7.68,1
5008,High Tension,2006,2850000,3681066,6435262,3585262,1.26,0
5009,Young Frankenstein,2011,2800000,86300000,86300000,83500000,29.82,1
5010,The Omen,2008,2800000,48570885,48577431,45777431,16.35,1
5011,Hustle &amp; Flow,2010,2800000,22202809,23591783,20791783,7.43,1
5012,Friday the 13th Part VII: The New Blood,2008,2800000,19170001,19170001,16370001,5.85,1
5013,Midnight Sun,2010,2800000,9561064,26952508,24152508,8.63,1
5015,The Wizard of Oz,2007,2777000,34685891,34949452,32172452,11.59,1
5017,The Black Stallion,2000,2700000,37799643,37799643,35099643,13.0,1
5018,Ulee's Gold,2013,2700000,9054736,15600000,12900000,4.78,1
5020,Lage Raho Munna Bhai,2017,2700000,2217561,31517561,28817561,10.67,1
5021,Sardaar Ji,2015,2700000,0,8200000,5500000,2.04,1
5023,Donovan's Reef,2016,2686000,6600000,6600000,3914000,1.46,0
5027,Blazing Saddles,2007,2600000,119500000,119500000,116900000,44.96,1
5028,Friday the 13th Part IV: The Final Chapter,2006,2600000,32980880,32980880,30380880,11.68,1
5029,Ida,2018,2600000,3827060,15298355,12698355,4.88,1
5033,La Cara Oculta,2015,2600000,0,7033931,4433931,1.71,1
5037,Singin' in the Rain,2011,2540000,7200000,7232802,4692802,1.85,1
5039,2016: Obamaâs America,2016,2500000,33349941,33349941,30849941,12.34,1
5046,Escape from the Planet of the Apes,2007,2500000,12300000,12300000,9800000,3.92,1
5048,The Spectacular Now,2008,2500000,6852971,6916951,4416951,1.77,1
5050,Before Sunrise,2001,2500000,5274005,5690220,3190220,1.28,0
5051,Hunt for the Wilderpeople,2002,2500000,5205471,23085599,20585599,8.23,1
5079,Get on the Bus,2003,2400000,5691854,5691854,3291854,1.37,0
5085,This is England,2003,2380000,327919,8739576,6359576,2.67,1
5087,Do You Believe?,2010,2300000,12985600,14628921,12328921,5.36,1
5095,Pinocchio,2018,2289247,84300000,84300000,82010753,35.82,1
5096,Fantasia,2017,2280000,83320000,83320000,81040000,35.54,1
5097,Friday the 13th Part 3,2008,2250000,36690067,36690067,34440067,15.31,1
5098,The French Connection,2006,2200000,41158757,41158757,38958757,17.71,1
5103,The Valley of Decision,2003,2160000,9132000,9132000,6972000,3.23,1
5106,The Best Years of Our Lives,2007,2100000,23600000,23600000,21500000,10.24,1
5110,[Rec],2011,2100000,0,23266821,21166821,10.08,1
5115,Courageous,2010,2000000,34522221,35185884,33185884,16.59,1
5118,Notorious,2005,2000000,24464742,24492698,22492698,11.25,1
5119,In the Heat of the Night,2008,2000000,24379978,24407647,22407647,11.2,1
5121,Everything You Always Wanted to Know,2006,2000000,18016290,18016290,16016290,8.01,1
5122,It Follows,2015,2000000,14674077,23236296,21236296,10.62,1
5124,To Kill A Mockingbird,2000,2000000,13129846,13129846,11129846,5.56,1
5125,Silent House,2005,2000000,12739737,16610760,14610760,7.31,1
5126,Boys Don't Cry,2010,2000000,11540607,20741000,18741000,9.37,1
5128,Hardcore Henry,2014,2000000,9252038,17187434,15187434,7.59,1
5129,Lolita,2008,2000000,9250000,9250000,7250000,3.62,1
5130,Boom Town,2001,2000000,9172000,9172000,7172000,3.59,1
5131,Gentleman's Agreement,2015,2000000,7800000,7800000,5800000,2.9,1
5132,The Hustler,2003,2000000,7600000,7600000,5600000,2.8,1
5133,Witchboard,2015,2000000,7369373,7369373,5369373,2.68,1
5134,Les Triplettes de Belleville,2017,2000000,7301288,17400005,15400005,7.7,1
5135,Smoke Signals,2009,2000000,6719300,7756617,5756617,2.88,1
5136,Winter's Bone,2012,2000000,6531503,16131551,14131551,7.07,1
5138,American Splendor,2009,2000000,6003587,8685632,6685632,3.34,1
5139,The Florida Project,2006,2000000,5904366,11295324,9295324,4.65,1
5140,All Saints,2010,2000000,5802208,5941994,3941994,1.97,1
5141,Before Sunset,2008,2000000,5792822,11217346,9217346,4.61,1
5142,Amores Perros,2010,2000000,5383834,20883834,18883834,9.44,1
5143,The Company You Keep,2006,2000000,5132442,21087760,19087760,9.54,1
5144,Thirteen,2013,2000000,4601043,9505996,7505996,3.75,1
5145,Touching the Void,2012,2000000,4593598,15396525,13396525,6.7,1
5146,Inside Job,2009,2000000,4311834,7799257,5799257,2.9,1
5148,Me and You and Everyone We Know,2015,2000000,3885134,9615464,7615464,3.81,1
5149,We Are Your Friends,2004,2000000,3591417,10153415,8153415,4.08,1
5150,Harsh Times,2012,2000000,3337931,6225304,4225304,2.11,1
5151,Ghost Dog: The Way of the Samurai,2015,2000000,3330230,10672492,8672492,4.34,1
5192,Knock Knock,2011,2000000,36336,6328516,4328516,2.16,1
5232,Buried,2007,1987650,1044143,21270290,19282640,9.7,1
5236,Man on Wire,2018,1900000,2962242,5617067,3717067,1.96,1
5248,A Nightmare on Elm Street,2016,1800000,25504513,25504513,23704513,13.17,1
5250,Dr. Strangelove,2002,1800000,9164370,9233730,7433730,4.13,1
5251,Battle for the Planet of the Apes,2013,1800000,8800000,8800000,7000000,3.89,1
5252,A Streetcar Named Desire,2016,1800000,8000000,8006717,6206717,3.45,1
5253,Hang 'em High,2005,1800000,6800000,6800000,5000000,2.78,1
5254,El crimen de padre Amaro,2016,1800000,5719000,5849791,4049791,2.25,1
5267,Lola rennt,2013,1750000,7267324,22879194,21129194,12.07,1
5271,In the Bedroom,2009,1700000,35930604,42137871,40437871,23.79,1
5272,La misma luna,2009,1700000,12590147,23271741,21571741,12.69,1
5273,Conquest of the Planet of the Apes,2015,1700000,9700000,9700000,8000000,4.71,1
5274,The Lunchbox,2014,1700000,4231500,15517886,13817886,8.13,1
5277,Saul fia,2014,1700000,1777043,9696537,7996537,4.7,1
5281,From Here to Eternity,2015,1650000,30500000,30500000,28850000,17.48,1
5283,Foolish,2015,1600000,6026908,6026908,4426908,2.77,1
5287,Sukkar banat,2016,1600000,1060591,14253760,12653760,7.91,1
5301,Mr. Smith Goes To Washington,2009,1500000,9000000,9000000,7500000,5.0,1
5302,Unsane,2007,1500000,7690044,14296709,12796709,8.53,1
5303,Kids,2000,1500000,7412216,20412216,18912216,12.61,1
5304,The Squid and the Whale,2015,1500000,7372734,11191423,9691423,6.46,1
5306,Spellbound,2005,1500000,7000000,7000000,5500000,3.67,1
5307,Run the Race,2003,1500000,6424420,6424420,4924420,3.28,1
5308,Dawn of the Dead,2014,1500000,5100000,55000000,53500000,35.67,1
5351,Snow White and the Seven Dwarfs,2012,1488000,184925486,184925486,183437486,123.28,1
5355,Mustang,2014,1400000,845464,5552584,4152584,2.97,1
5364,"Lock, Stock and Two Smoking Barrels",2002,1350000,3897569,28356188,27006188,20.0,1
5392,Saw,2018,1200000,55968727,103880027,102680027,85.57,1
5394,Super Troopers,2015,1200000,18492362,23182223,21982223,18.32,1
5395,Monsoon Wedding,2017,1200000,13876974,27025600,25825600,21.52,1
5396,You Can Count on Me,2012,1200000,9180275,10827356,9627356,8.02,1
5397,Strangers on a Train,2008,1200000,7000000,7020059,5820059,4.85,1
5398,The Trouble with Harry,2012,1200000,7000000,7000000,5800000,4.83,1
5399,"Il buono, il brutto, il cattivo",2014,1200000,6100000,6100000,4900000,4.08,1
5425,Godâs Not Dead,2011,1150000,60755732,63777092,62627092,54.46,1
5426,Waiting...,2003,1125000,16124543,18673274,17548274,15.6,1
5429,Wolf Creek,2013,1100000,16186348,29005064,27905064,25.37,1
5430,Ong-Bak,2003,1100000,4563167,24062965,22962965,20.88,1
5431,Serbuan maut,2007,1100000,4105123,9297407,8197407,7.45,1
5446,Casablanca,2005,1039000,10462500,10508632,9469632,9.11,1
5447,Rocky,2011,1000000,117235147,225000000,224000000,224.0,1
5448,The Devil Inside,2016,1000000,53262945,101759490,100759490,100.76,1
5451,An Inconvenient Truth,2001,1000000,24146161,53365925,52365925,52.37,1
5452,You're Next,2015,1000000,18494006,26887177,25887177,25.89,1
5453,Chernobyl Diaries,2000,1000000,18119640,42411721,41411721,41.41,1
5454,The Howling,2010,1000000,17985000,17985000,16985000,16.98,1
5455,Dr. No,2007,1000000,16067035,59567035,58567035,58.57,1
5456,Hellraiser,2014,1000000,14564000,14575148,13575148,13.58,1
5457,"Hello, My Name is Doris",2008,1000000,14444999,14662703,13662703,13.66,1
5458,Cry Wolf,2015,1000000,10047674,15943081,14943081,14.94,1
5460,Blue Valentine,2005,1000000,9737892,16566240,15566240,15.57,1
5461,Transamerica,2015,1000000,9015303,16553163,15553163,15.55,1
5462,Beyond the Valley of the Dolls,2006,1000000,9000000,9000000,8000000,8.0,1
5463,Love Me Tender,2002,1000000,9000000,9000000,8000000,8.0,1
5464,Unfriended: Dark Web,2013,1000000,8866745,16434588,15434588,15.43,1
5465,Sands of Iwo Jima,2015,1000000,7800000,7800000,6800000,6.8,1
5466,The Green Inferno,2015,1000000,7192291,12931420,11931420,11.93,1
5467,I Am Not Your Negro,2009,1000000,7123919,9617402,8617402,8.62,1
5468,The Sessions,2006,1000000,6002451,11495204,10495204,10.5,1
5469,Shine a Light,2003,1000000,5505267,16173879,15173879,15.17,1
5471,The Skeleton Twins,2005,1000000,5284309,5797192,4797192,4.8,1
5472,20 Feet From Stardom,2008,1000000,4946250,5892466,4892466,4.89,1
5474,An Inconvenient Sequel,2012,1000000,3496795,5839322,4839322,4.84,1
5479,Frozen River,2013,1000000,2511476,6030129,5030129,5.03,1
5567,Hard Candy,2018,950000,1024640,8267066,7317066,7.7,1
5575,Lowriders,2007,916000,6179955,6188421,5272421,5.76,1
5577,On the Waterfront,2015,910000,9600000,9600000,8690000,9.55,1
5578,Fruitvale Station,2015,900000,16098998,17549645,16649645,18.5,1
5579,Meet the Blacks,2002,900000,9097072,9097072,8197072,9.11,1
5580,"4 luni, 3 saptamani si 2 zile",2014,900000,1196321,11993156,11093156,12.33,1
5588,Searching,2014,880000,26015149,76090613,75210613,85.47,1
5589,Bambi,2012,858000,102797000,268000000,267142000,311.35,1
5600,Billy Jack,2011,800000,98000000,98000000,97200000,121.5,1
5601,Jodaeiye Nader az Simin,2004,800000,7098492,24426169,23626169,29.53,1
5615,American Graffiti,2013,777000,115000000,140000000,139223000,179.18,1
5617,Kevin Hart: Laugh at My Pain,2014,750000,7706436,7712436,6962436,9.28,1
5618,Aqua Teen Hunger Force Colon Movie Film for The…,2011,750000,5520368,5520368,4770368,6.36,1
5631,High Noon,2012,730000,8000000,8000000,7270000,9.96,1
5632,Hoop Dreams,2007,700000,7768371,11768371,11068371,15.81,1
5640,King Kong,2015,672000,10000000,10000650,9328650,13.88,1
5641,House of Wax,2016,658000,23800000,23800000,23142000,35.17,1
5651,The Blair Witch Project,2006,600000,140539099,248300000,247700000,412.83,1
5653,The Kentucky Fried Movie,2006,600000,15000000,20000000,19400000,32.33,1
5669,Friday the 13th,2004,550000,39754601,59754601,59204601,107.64,1
5673,Fireproof,2001,500000,33456317,33473297,32973297,65.95,1
5674,Benji,2004,500000,31559560,31559560,31059560,62.12,1
5675,Open Water,2005,500000,30500882,55518641,55018641,110.04,1
5678,The Station Agent,2005,500000,5801558,9470209,8970209,17.94,1
5706,Home,2011,500000,15433,44793168,44293168,88.59,1
5740,Paranormal Activity,2014,450000,107918810,194183034,193733034,430.52,1
5753,Twenty-Two,2015,425000,22222,25733825,25308825,59.55,1
5756,Napoleon Dynamite,2008,400000,44540956,46122713,45722713,114.31,1
5774,The Evil Dead,2002,375000,2400000,29400000,29025000,77.4,1
5776,Maniac,2008,350000,10000000,10000000,9650000,27.57,1
5785,Halloween,2008,325000,47000000,70000000,69675000,214.38,1
5789,Tupac Resurrection,2015,300000,7718961,7808524,7508524,25.03,1
5819,Graduation Day,2006,250000,23894000,23894000,23644000,94.58,1
5858,The Big Parade,2013,245000,11000000,22000000,21755000,88.8,1
5865,The Stewardesses,2015,200000,13500000,25000000,24800000,124.0,1
5866,Mad Max,2015,200000,8750000,99750000,99550000,497.75,1
5867,"20,000 Leagues Under the Sea",2013,200000,8000000,8000000,7800000,39.0,1
5868,Swingers,2000,200000,4505922,6618578,6418578,32.09,1
5899,She's Gotta Have It,2010,175000,7137502,7137502,6962502,39.79,1
5908,Sweet Sweetback's Baad Asssss Song,2015,150000,15200000,15200000,15050000,100.33,1
5909,Once,2012,150000,9445857,23151277,23001277,153.34,1
